name,url,last_month_installs,this_month_installs,installs_m_m_growth,last_month_multiple
VMware Tanzu Greenplum (BYOL),https://azuremarketplace.microsoft.com/en-us/marketplace/apps/pivotal.pivotal-greenplum-azure-byol?exp=ubp8&tab=Overview,1,27,26,27.0
Prefect 1,https://azuremarketplace.microsoft.com/en-us/marketplace/apps/prefecttechnologiesinc1606247647944.prefect_cloud?exp=ubp8&tab=Overview,7,121,114,17.3
CData API Server,https://azuremarketplace.microsoft.com/en-us/marketplace/apps/cdatasoftware.cdataapiserver?exp=ubp8&tab=Overview,2,16,14,8.0
Volody Contract Management Software,https://azuremarketplace.microsoft.com/en-us/marketplace/apps/volodyproductspltd1610011615564.volody_clm?exp=ubp8&tab=Overview,1,8,7,8.0
Skylight Analytics,https://azuremarketplace.microsoft.com/en-us/marketplace/apps/accediannetworks1624483188184.ms_skylight_analytics?exp=ubp8&tab=Overview,1,7,6,7.0
City Graph,https://azuremarketplace.microsoft.com/en-us/marketplace/apps/siemens-advanta.citygraph?exp=ubp8&tab=Overview,2,13,11,6.5
Palantir Foundry,https://azuremarketplace.microsoft.com/en-us/marketplace/apps/palantirtechnologies1585670280063.palantir_foundry?exp=ubp8&tab=Overview,2,13,11,6.5
Getron Services,https://azuremarketplace.microsoft.com/en-us/marketplace/apps/getron_bilisim_hizmetleri.getron_advisor?exp=ubp8&tab=Overview,2,10,8,5.0
Neural Designer,https://azuremarketplace.microsoft.com/en-us/marketplace/apps/artificial-intelligence-techniques-sl.neural-designer-cloud?exp=ubp8&tab=Overview,1,5,4,5.0
dotnet Report Builder,https://azuremarketplace.microsoft.com/en-us/marketplace/apps/dotreportinc1647318974647.dotnetreport?exp=ubp8&tab=Overview,1,5,4,5.0
data.world,https://azuremarketplace.microsoft.com/en-us/marketplace/apps/datadotworld.datadotworld?exp=ubp8&tab=Overview,2,10,8,5.0
iFinder Enterprise Search,https://azuremarketplace.microsoft.com/en-us/marketplace/apps/intrafindag1594300036498.ifinder?exp=ubp8&tab=Overview,3,13,10,4.3
Synerise AI Growth Cloud,https://azuremarketplace.microsoft.com/en-us/marketplace/apps/synerise.saigc?exp=ubp8&tab=Overview,3,12,9,4.0
Golang on Ubuntu18.04LTS,https://azuremarketplace.microsoft.com/en-us/marketplace/apps/apps-4-rent.golang-on-ubuntu18?exp=ubp8&tab=Overview,1,3,2,3.0
VaultSpeed,https://azuremarketplace.microsoft.com/en-us/marketplace/apps/vaultspeednv1623916156161.vaultspeed-azure-marketpalce?exp=ubp8&tab=Overview,1,3,2,3.0
Sinequa Search Cloud Platform,https://azuremarketplace.microsoft.com/en-us/marketplace/apps/sinequa.sinequa_macc_enabled?exp=ubp8&tab=Overview,1,3,2,3.0
Bizom,https://azuremarketplace.microsoft.com/en-us/marketplace/apps/mobisy.bizom?exp=ubp8&tab=Overview,5,15,10,3.0
Sinequa for Azure,https://azuremarketplace.microsoft.com/en-us/marketplace/apps/sinequa.sinequa_for_azure_contact_me?exp=ubp8&tab=Overview,1,3,2,3.0
Blue Prism Intelligent Automation,https://azuremarketplace.microsoft.com/en-us/marketplace/apps/blueprismlimited-4827145.blueprism?exp=ubp8&tab=Overview,1,3,2,3.0
Azure AI Content Safety,https://azuremarketplace.microsoft.com/en-us/marketplace/apps/Microsoft.CognitiveServicesContentSafety?exp=ubp8&tab=Overview,1,3,2,3.0
EcoVadis Sustainability Ratings,https://azuremarketplace.microsoft.com/en-us/marketplace/apps/ecovadis1578946401678.ecovadis_sustainability_ratings_api_integration?exp=ubp8&tab=Overview,11,32,21,2.9
ToolsGroup Service Optimizer 99+ (SO99+),https://azuremarketplace.microsoft.com/en-us/marketplace/apps/toolsgroup.toolsgroup-so99?exp=ubp8&tab=Overview,18,49,31,2.7
EcoVadis Business Sustainability Ratings,https://azuremarketplace.microsoft.com/en-us/marketplace/apps/ecovadis1578946401678.ecovadis-rating?exp=ubp8&tab=Overview,13,34,21,2.6
impress.ai,https://azuremarketplace.microsoft.com/en-us/marketplace/apps/ideatorypteltdimpress1609301500165.impress_basic?exp=ubp8&tab=Overview,2,5,3,2.5
365Talents - Talent Experience powered by AI,https://azuremarketplace.microsoft.com/en-us/marketplace/apps/365talents.365talents_skills_management?exp=ubp8&tab=Overview,26,65,39,2.5
Zscaler Digital Experience,https://azuremarketplace.microsoft.com/en-us/marketplace/apps/zscaler1579058425289.zdx?exp=ubp8&tab=Overview,18,43,25,2.4
Datarails,https://azuremarketplace.microsoft.com/en-us/marketplace/apps/datarails.datarails?exp=ubp8&tab=Overview,60,142,82,2.4
Azure OpenAI,https://azuremarketplace.microsoft.com/en-us/marketplace/apps/Microsoft.CognitiveServicesOpenAI?exp=ubp8&tab=Overview,60,145,85,2.4
ClickCompliance,https://azuremarketplace.microsoft.com/en-us/marketplace/apps/clickcompliance.clickcompliance?exp=ubp8&tab=Overview,3,7,4,2.3
Hyperview - Cloud-based DCIM Software,https://azuremarketplace.microsoft.com/en-us/marketplace/apps/hyperviewtechnologiesinc1592511925982.hv50-plan?exp=ubp8&tab=Overview,8,18,10,2.3
Eggplant Digital Automation Intelligence,https://azuremarketplace.microsoft.com/en-us/marketplace/apps/eggplant.eggplant_dai1?exp=ubp8&tab=Overview,42,95,53,2.3
StreamSets Data Collector,https://azuremarketplace.microsoft.com/en-us/marketplace/apps/streamsets.streamsets-data-collector?exp=ubp8&tab=Overview,46,100,54,2.2
Teradata Vantage (DIY),https://azuremarketplace.microsoft.com/en-us/marketplace/apps/teradata.vantage-teradata-database-template?exp=ubp8&tab=Overview,134,279,145,2.1
Domino Data Lab for Azure,https://azuremarketplace.microsoft.com/en-us/marketplace/apps/dominodatalab.domino-azure?exp=ubp8&tab=Overview,11,23,12,2.1
Composable,https://azuremarketplace.microsoft.com/en-us/marketplace/apps/composable.composable?exp=ubp8&tab=Overview,10,21,11,2.1
"Teradata Vantage (DIY, IntelliSphere)",https://azuremarketplace.microsoft.com/en-us/marketplace/apps/teradata.vantage-teradata-database-intellisphere-template?exp=ubp8&tab=Overview,134,279,145,2.1
Teradata Vantage on Azure (International),https://azuremarketplace.microsoft.com/en-us/marketplace/apps/teradatainternationalsaleslimiteds1597360184313.teradata-vantage-aas-international?exp=ubp8&tab=Overview,134,278,144,2.1
Ruby on Ubuntu20.04LTS,https://azuremarketplace.microsoft.com/en-us/marketplace/apps/apps-4-rent.ruby-on-ubuntu20?exp=ubp8&tab=Overview,1,2,1,2.0
Talview Video Interviewing,https://azuremarketplace.microsoft.com/en-us/marketplace/apps/talview.tv_interviewing?exp=ubp8&tab=Overview,33,65,32,2.0
Talview Video Interviewing,https://azuremarketplace.microsoft.com/en-us/marketplace/apps/talview.tv_interviewing?exp=ubp8&tab=Overview,33,65,32,2.0
Matillion ETL,https://azuremarketplace.microsoft.com/en-us/marketplace/apps/matillion.matillion-solution-template?exp=ubp8&tab=Overview,36,72,36,2.0
Apache Spark on Ubuntu 18.04,https://azuremarketplace.microsoft.com/en-us/marketplace/apps/apps-4-rent.apache-spark-on-ubuntu1804?exp=ubp8&tab=Overview,1,2,1,2.0
HCL Accelerate on Azure,https://azuremarketplace.microsoft.com/en-us/marketplace/apps/hcl-technologies.hcl_devops_accelerate_app?exp=ubp8&tab=Overview,1,2,1,2.0
Chatlayer.ai,https://azuremarketplace.microsoft.com/en-us/marketplace/apps/chatlayerai1582731604769.chatlayerai?exp=ubp8&tab=Overview,1,2,1,2.0
Talview Behavioral Insights,https://azuremarketplace.microsoft.com/en-us/marketplace/apps/talview-5044333.talview_behaviour_insights?exp=ubp8&tab=Overview,33,65,32,2.0
Talview Remote Proctoring,https://azuremarketplace.microsoft.com/en-us/marketplace/apps/talview-5044333.talview_remote_proctoring?exp=ubp8&tab=Overview,33,65,32,2.0
AnyVision,https://azuremarketplace.microsoft.com/en-us/marketplace/apps/anyvisioninteractivetechnologies.anyvision?exp=ubp8&tab=Overview,1,2,1,2.0
Fractal RTM,https://azuremarketplace.microsoft.com/en-us/marketplace/apps/fractal.fractalrtm?exp=ubp8&tab=Overview,2,4,2,2.0
novisto_software,https://azuremarketplace.microsoft.com/en-us/marketplace/apps/novisto1586884908995.novisto?exp=ubp8&tab=Overview,3,6,3,2.0
TrendMiner,https://azuremarketplace.microsoft.com/en-us/marketplace/apps/softwareagusainc.trendminer?exp=ubp8&tab=Overview,69,141,72,2.0
erwin Data Intelligence,https://azuremarketplace.microsoft.com/en-us/marketplace/apps/erwininc.erwin_di?exp=ubp8&tab=Overview,1,2,1,2.0
TrueCue Platform,https://azuremarketplace.microsoft.com/en-us/marketplace/apps/concentra.truecue-platform?exp=ubp8&tab=Overview,1,2,1,2.0
Elasticsearch on Windows Server 2022,https://azuremarketplace.microsoft.com/en-us/marketplace/apps/apps-4-rent.elasticsearch-on-win2022?exp=ubp8&tab=Overview,1,2,1,2.0
Alluvio NetProfiler,https://azuremarketplace.microsoft.com/en-us/marketplace/apps/riverbed.netprofiler?exp=ubp8&tab=Overview,1,2,1,2.0
Contiamo Datahub,https://azuremarketplace.microsoft.com/en-us/marketplace/apps/contiamogmbh.contiamo?exp=ubp8&tab=Overview,1,2,1,2.0
Governance Toolkit 365,https://azuremarketplace.microsoft.com/en-us/marketplace/apps/atwork.governancetoolkit365?exp=ubp8&tab=Overview,1,2,1,2.0
Talview Live Proctoring,https://azuremarketplace.microsoft.com/en-us/marketplace/apps/talview.talview_live_proctoring?exp=ubp8&tab=Overview,33,65,32,2.0
KETL,https://azuremarketplace.microsoft.com/en-us/marketplace/apps/ketlsrl1635149456452.ketl?exp=ubp8&tab=Overview,1,2,1,2.0
Zap Automation,https://azuremarketplace.microsoft.com/en-us/marketplace/apps/zappyailimited1596269789053.zappy_ai-offer?exp=ubp8&tab=Overview,1,2,1,2.0
Matillion Data Productivity Cloud,https://azuremarketplace.microsoft.com/en-us/marketplace/apps/matillion.matillion-etl-billing?exp=ubp8&tab=Overview,36,72,36,2.0
Talview Video Interviewing,https://azuremarketplace.microsoft.com/en-us/marketplace/apps/talview.tv02187?exp=ubp8&tab=Overview,33,65,32,2.0
Talview Video Interviewing,https://azuremarketplace.microsoft.com/en-us/marketplace/apps/talview.tv02187?exp=ubp8&tab=Overview,33,65,32,2.0
Azure DSVM for PyTorch,https://azuremarketplace.microsoft.com/en-us/marketplace/apps/microsoft-dsvm.acpt-vm?exp=ubp8&tab=Overview,1,2,1,2.0
SearchUnify - Unified Cognitive Platform,https://azuremarketplace.microsoft.com/en-us/marketplace/apps/grazittiinteractive1579237688624.searchunify_enterprise?exp=ubp8&tab=Overview,35,66,31,1.9
Bunifu Framework - Visual Studio .NET UI tools,https://azuremarketplace.microsoft.com/en-us/marketplace/apps/bunifutechnologiesltd.bunifudevtools?exp=ubp8&tab=Overview,9,17,8,1.9
Cloud FastPath,https://azuremarketplace.microsoft.com/en-us/marketplace/apps/cloud-fastpath.a9596bbd-78f0-4514-84d1-82f6ff0992fd?exp=ubp8&tab=Overview,9,17,8,1.9
Cloud Fastpath,https://azuremarketplace.microsoft.com/en-us/marketplace/apps/tervelainc-4740521.cloudfastpath?exp=ubp8&tab=Overview,9,17,8,1.9
IBM OpenPages with Watson,https://azuremarketplace.microsoft.com/en-us/marketplace/apps/ibm-usa-ny-armonk-hq-6275750-ibmcloud-asperia.ibm-cloud-pak-for-data-openpages?exp=ubp8&tab=Overview,28,51,23,1.8
FortiAnalyzer Centralized Log Analytics,https://azuremarketplace.microsoft.com/en-us/marketplace/apps/fortinet.fortianalyzer?exp=ubp8&tab=Overview,16,28,12,1.8
Nexthink Experience,https://azuremarketplace.microsoft.com/en-us/marketplace/apps/nexthink.nexthink_cloud_edition?exp=ubp8&tab=Overview,126,233,107,1.8
Nexthink,https://azuremarketplace.microsoft.com/en-us/marketplace/apps/nexthink.nexthink?exp=ubp8&tab=Overview,126,233,107,1.8
Voyado,https://azuremarketplace.microsoft.com/en-us/marketplace/apps/revide-2109359.voyado?exp=ubp8&tab=Overview,15,27,12,1.8
1000minds Decision-Making,https://azuremarketplace.microsoft.com/en-us/marketplace/apps/1000mindslimited1623888531346.1000minds-dm?exp=ubp8&tab=Overview,16,29,13,1.8
Basware Procurement,https://azuremarketplace.microsoft.com/en-us/marketplace/apps/baswareoyj.procurement?exp=ubp8&tab=Overview,60,109,49,1.8
Aiven for Apache Kafka,https://azuremarketplace.microsoft.com/en-us/marketplace/apps/aivenltd1590663507662.aiven_kafka?exp=ubp8&tab=Overview,110,187,77,1.7
WhereScape® RED automation software,https://azuremarketplace.microsoft.com/en-us/marketplace/apps/wherescapesoftware.wherescape-red?exp=ubp8&tab=Overview,23,40,17,1.7
Cisco Cloud Services Router (CSR) 1000V,https://azuremarketplace.microsoft.com/en-us/marketplace/apps/cisco.cisco-csr-1000v?exp=ubp8&tab=Overview,21,35,14,1.7
ArcGIS Image,https://azuremarketplace.microsoft.com/en-us/marketplace/apps/esri.arcgis-image?exp=ubp8&tab=Overview,7,11,4,1.6
TigerGraph Cloud,https://azuremarketplace.microsoft.com/en-us/marketplace/apps/tigergraph.tigergraph-cloud?exp=ubp8&tab=Overview,5,8,3,1.6
TIBCO EBX,https://azuremarketplace.microsoft.com/en-us/marketplace/apps/tibco-software.tibco-ebx?exp=ubp8&tab=Overview,41,66,25,1.6
CloudAtlas Supervisor,https://azuremarketplace.microsoft.com/en-us/marketplace/apps/unify-cloud-llc.cloudsupervisorazure?exp=ubp8&tab=Overview,7,11,4,1.6
@RISK,https://azuremarketplace.microsoft.com/en-us/marketplace/apps/palisadecorp1610462250663.at_risk?exp=ubp8&tab=Overview,7,11,4,1.6
Safetica ONE,https://azuremarketplace.microsoft.com/en-us/marketplace/apps/safetica_technologies.safetica_dlp?exp=ubp8&tab=Overview,69,107,38,1.6
ElectroNeek RPA,https://azuremarketplace.microsoft.com/en-us/marketplace/apps/electroneekrobotic1581669111204.electroneek_platform?exp=ubp8&tab=Overview,79,125,46,1.6
ElectroNeek RPA,https://azuremarketplace.microsoft.com/en-us/marketplace/apps/electroneekrobotic1581669111204.electroneek_platform?exp=ubp8&tab=Overview,79,125,46,1.6
ElectroNeek RPA,https://azuremarketplace.microsoft.com/en-us/marketplace/apps/electroneekrobotic1581669111204.electroneek_rpa?exp=ubp8&tab=Overview,79,125,46,1.6
ElectroNeek RPA,https://azuremarketplace.microsoft.com/en-us/marketplace/apps/electroneekrobotic1581669111204.electroneek_rpa?exp=ubp8&tab=Overview,79,125,46,1.6
RStudio on Ubuntu18.04LTS,https://azuremarketplace.microsoft.com/en-us/marketplace/apps/apps-4-rent.rstudio-on-ubuntu18?exp=ubp8&tab=Overview,2,3,1,1.5
TimeXtender,https://azuremarketplace.microsoft.com/en-us/marketplace/apps/timextender.timextender?exp=ubp8&tab=Overview,59,88,29,1.5
Power BI Embedded,https://azuremarketplace.microsoft.com/en-us/marketplace/apps/Microsoft.PowerBIDedicated?exp=ubp8&tab=Overview,115,167,52,1.5
MiHCM Analytics,https://azuremarketplace.microsoft.com/en-us/marketplace/apps/microimageprivatelimited-4916760.mihcm_analytics?exp=ubp8&tab=Overview,2,3,1,1.5
Postgresql on Centos7,https://azuremarketplace.microsoft.com/en-us/marketplace/apps/apps-4-rent.postgresql-on-centos7?exp=ubp8&tab=Overview,2,3,1,1.5
TimeXtender® Application Server,https://azuremarketplace.microsoft.com/en-us/marketplace/apps/timextender.timextender_disocveryhub_vm?exp=ubp8&tab=Overview,59,88,29,1.5
process.science Process Mining,https://azuremarketplace.microsoft.com/en-us/marketplace/apps/processsciencegmbhcokg1590595423984.processsciencewebapp?exp=ubp8&tab=Overview,2,3,1,1.5
ProScheduler WFM,https://azuremarketplace.microsoft.com/en-us/marketplace/apps/loxysoft.proscheduler?exp=ubp8&tab=Overview,2,3,1,1.5
MiHCM Enterprise,https://azuremarketplace.microsoft.com/en-us/marketplace/apps/microimageprivatelimited-4916760.microimagehcmcloud?exp=ubp8&tab=Overview,2,3,1,1.5
Mphasis CG,https://azuremarketplace.microsoft.com/en-us/marketplace/apps/mphasis.mphasis_cg?exp=ubp8&tab=Overview,2,3,1,1.5
SearchBlox Enterprise Search,https://azuremarketplace.microsoft.com/en-us/marketplace/apps/searchbloxsoftwareinc1594309037050.searchblox-enterprise-search?exp=ubp8&tab=Overview,2,3,1,1.5
EcoStruxure Resource Advisor,https://azuremarketplace.microsoft.com/en-us/marketplace/apps/869296.ecostruxure_resource_advisor?exp=ubp8&tab=Overview,2,3,1,1.5
MiHCM Lite,https://azuremarketplace.microsoft.com/en-us/marketplace/apps/microimageprivatelimited-4916760.mihcm_for_smb?exp=ubp8&tab=Overview,2,3,1,1.5
Business Central UAE localized Payroll and HRMS,https://azuremarketplace.microsoft.com/en-us/marketplace/apps/squareinternationaltechnologyconsultingdmcc.businesscentral_hrms_payroll?exp=ubp8&tab=Overview,2,3,1,1.5
Akenza IoT Platform,https://azuremarketplace.microsoft.com/en-us/marketplace/apps/hivemindag.akenza_core?exp=ubp8&tab=Overview,4,6,2,1.5
ASC Recording Insights,https://azuremarketplace.microsoft.com/en-us/marketplace/apps/asctechnologiesag.asc_recordinginsights?exp=ubp8&tab=Overview,2,3,1,1.5
Squirrel Cloud POS,https://azuremarketplace.microsoft.com/en-us/marketplace/apps/squirrelsystems.squirrelcloudpos?exp=ubp8&tab=Overview,24,36,12,1.5
AppScale,https://azuremarketplace.microsoft.com/en-us/marketplace/apps/appscale-marketplace.appscale?exp=ubp8&tab=Overview,6,9,3,1.5
Phonex One,https://azuremarketplace.microsoft.com/en-us/marketplace/apps/mindcti.phonexone?exp=ubp8&tab=Overview,2,3,1,1.5
DataStax Enterprise,https://azuremarketplace.microsoft.com/en-us/marketplace/apps/datastax.datastax-dse-azure?exp=ubp8&tab=Overview,13,20,7,1.5
Fortinet FortiSIEM - SIEM & Analytics,https://azuremarketplace.microsoft.com/en-us/marketplace/apps/fortinet.fortinet-fortisiem-vm?exp=ubp8&tab=Overview,25,38,13,1.5
Augury Machine Health,https://azuremarketplace.microsoft.com/en-us/marketplace/apps/auguryinc1612988011558.halo?exp=ubp8&tab=Overview,2,3,1,1.5
Language service,https://azuremarketplace.microsoft.com/en-us/marketplace/apps/Microsoft.CognitiveServicesTextAnalytics?exp=ubp8&tab=Overview,2,3,1,1.5
OverOps for Azure,https://azuremarketplace.microsoft.com/en-us/marketplace/apps/overops.overops?exp=ubp8&tab=Overview,9,13,4,1.4
Onfido Identity Verification Solution,https://azuremarketplace.microsoft.com/en-us/marketplace/apps/onfido-5084500.onfidoidentifycheckingsolution?exp=ubp8&tab=Overview,62,87,25,1.4
Simcenter STAR-CCM+,https://azuremarketplace.microsoft.com/en-us/marketplace/apps/siemensplmsoftware.starccm_on_azure?exp=ubp8&tab=Overview,92,128,36,1.4
Feedback Cloud,https://azuremarketplace.microsoft.com/en-us/marketplace/apps/odcemtechnologiespvtltd1603256553330.fc112020?exp=ubp8&tab=Overview,7,10,3,1.4
Blue Yonder Workforce Management,https://azuremarketplace.microsoft.com/en-us/marketplace/apps/jdasoftware-global.jda_workforce_management_appsource?exp=ubp8&tab=Overview,9,13,4,1.4
Unravel for Azure Databricks,https://azuremarketplace.microsoft.com/en-us/marketplace/apps/unravel-data.unravel-databricks-app?exp=ubp8&tab=Overview,22,30,8,1.4
Unravel for Azure Databricks,https://azuremarketplace.microsoft.com/en-us/marketplace/apps/unravel-data.unravel-databricks-app?exp=ubp8&tab=Overview,22,30,8,1.4
OMNI,https://azuremarketplace.microsoft.com/en-us/marketplace/apps/airodigitallab1590473566928.omni?exp=ubp8&tab=Overview,9,13,4,1.4
o9 Merchandising and Assortment Planning,https://azuremarketplace.microsoft.com/en-us/marketplace/apps/o9solutions.o9-map?exp=ubp8&tab=Overview,11,15,4,1.4
o9 Supply Chain Management,https://azuremarketplace.microsoft.com/en-us/marketplace/apps/o9solutions.o9-scm?exp=ubp8&tab=Overview,11,15,4,1.4
o9 Revenue Management,https://azuremarketplace.microsoft.com/en-us/marketplace/apps/o9solutions.o9-revmgmt?exp=ubp8&tab=Overview,11,15,4,1.4
Spirion Sensitive Data Manager,https://azuremarketplace.microsoft.com/en-us/marketplace/apps/spirion1595360090112.spr_sd_manager?exp=ubp8&tab=Overview,9,13,4,1.4
Spirion Sensitive Data Platform,https://azuremarketplace.microsoft.com/en-us/marketplace/apps/spirion1595360090112.spr_sd_platform?exp=ubp8&tab=Overview,9,13,4,1.4
Cloudera-CentOS-OS-Image,https://azuremarketplace.microsoft.com/en-us/marketplace/apps/cloudera.cloudera-centos-os?exp=ubp8&tab=Overview,27,34,7,1.3
Data Share,https://azuremarketplace.microsoft.com/en-us/marketplace/apps/Microsoft.DataShare?exp=ubp8&tab=Overview,4,5,1,1.3
Azure Synapse Analytics,https://azuremarketplace.microsoft.com/en-us/marketplace/apps/Microsoft.Synapse?exp=ubp8&tab=Overview,54,70,16,1.3
Valohai MLOps Platform,https://azuremarketplace.microsoft.com/en-us/marketplace/apps/valohai.valohai-workers?exp=ubp8&tab=Overview,20,25,5,1.3
Cloudera Data Platform (CDP),https://azuremarketplace.microsoft.com/en-us/marketplace/apps/cloudera.cloudera-data-platform-public-cloud-contact?exp=ubp8&tab=Overview,27,34,7,1.3
o9 Integrated Business Planning,https://azuremarketplace.microsoft.com/en-us/marketplace/apps/o9solutions.o9-ibp-mfg?exp=ubp8&tab=Overview,14,18,4,1.3
Moovit MaaS,https://azuremarketplace.microsoft.com/en-us/marketplace/apps/moovit.moovit_maas?exp=ubp8&tab=Overview,3,4,1,1.3
CallMiner Eureka,https://azuremarketplace.microsoft.com/en-us/marketplace/apps/callminer1592491093842.callminer_eureka?exp=ubp8&tab=Overview,147,185,38,1.3
CallMiner Eureka,https://azuremarketplace.microsoft.com/en-us/marketplace/apps/callminer1592491093842.callminer_eureka?exp=ubp8&tab=Overview,147,185,38,1.3
Trifacta for Azure,https://azuremarketplace.microsoft.com/en-us/marketplace/apps/trifactainc1587522950142.trifactaazure?exp=ubp8&tab=Overview,123,156,33,1.3
Zoho Analytics On-Premise (BYOL),https://azuremarketplace.microsoft.com/en-us/marketplace/apps/site24x7.zoho_analytics_on-premise?exp=ubp8&tab=Overview,210,267,57,1.3
deFacto Power Planning,https://azuremarketplace.microsoft.com/en-us/marketplace/apps/defactoglobalinc.defatosaas00001?exp=ubp8&tab=Overview,4,5,1,1.3
MachEye Essentials,https://azuremarketplace.microsoft.com/en-us/marketplace/apps/macheyeinc1609360234525.macheye_essentials_1?exp=ubp8&tab=Overview,8,10,2,1.3
MachEye Premium,https://azuremarketplace.microsoft.com/en-us/marketplace/apps/macheyeinc1609360234525.macheye_premium_1?exp=ubp8&tab=Overview,8,10,2,1.3
Cloudera Data Platform (CDP) 7.2.x Runtimes,https://azuremarketplace.microsoft.com/en-us/marketplace/apps/cloudera.cloudera-data-platform-cdp-7_2?exp=ubp8&tab=Overview,27,34,7,1.3
trueChart,https://azuremarketplace.microsoft.com/en-us/marketplace/apps/highcoordination.truechart4excel?exp=ubp8&tab=Overview,4,5,1,1.3
Zoho Analytics,https://azuremarketplace.microsoft.com/en-us/marketplace/apps/zohocorp.zohoanalytics?exp=ubp8&tab=Overview,214,271,57,1.3
CallMiner Eureka,https://azuremarketplace.microsoft.com/en-us/marketplace/apps/callminer1592491093842.callmineroffer1?exp=ubp8&tab=Overview,147,185,38,1.3
CallMiner Eureka,https://azuremarketplace.microsoft.com/en-us/marketplace/apps/callminer1592491093842.callmineroffer1?exp=ubp8&tab=Overview,147,185,38,1.3
Kepion Cloud,https://azuremarketplace.microsoft.com/en-us/marketplace/apps/kepion.kepioncloud?exp=ubp8&tab=Overview,8,10,2,1.3
MeBeBot Intelligent Assistant,https://azuremarketplace.microsoft.com/en-us/marketplace/apps/mebebot1616523123397.mebebot_contactus?exp=ubp8&tab=Overview,9,12,3,1.3
adenin Digital Assistant,https://azuremarketplace.microsoft.com/en-us/marketplace/apps/adenintechnologiesinc1605897155825.digital_assistant_saas?exp=ubp8&tab=Overview,4,5,1,1.3
ModelOp Center,https://azuremarketplace.microsoft.com/en-us/marketplace/apps/modelop.modelop_center?exp=ubp8&tab=Overview,4,5,1,1.3
NLP Cloud API,https://azuremarketplace.microsoft.com/en-us/marketplace/apps/soupeo1619797935412.nlpcloud_api?exp=ubp8&tab=Overview,4,5,1,1.3
Sisense Server,https://azuremarketplace.microsoft.com/en-us/marketplace/apps/sisenseltd.sisense-server?exp=ubp8&tab=Overview,758,956,198,1.3
NLP Lab,https://azuremarketplace.microsoft.com/en-us/marketplace/apps/johnsnowlabsinc1646051154808.annotation_lab?exp=ubp8&tab=Overview,3,4,1,1.3
ArcGIS Enterprise,https://azuremarketplace.microsoft.com/en-us/marketplace/apps/esri.arcgis-enterprise?exp=ubp8&tab=Overview,53,67,14,1.3
SAS® Viya® (Pay-As-You-Go),https://azuremarketplace.microsoft.com/en-us/marketplace/apps/sas-institute-560503.sas-viya-on-azure?exp=ubp8&tab=Overview,588,774,186,1.3
Statsig,https://azuremarketplace.microsoft.com/en-us/marketplace/apps/statsiginc1610354169520.statsig?exp=ubp8&tab=Overview,39,48,9,1.2
Haptik,https://azuremarketplace.microsoft.com/en-us/marketplace/apps/jioplatformslimited1657086280629.haptik?exp=ubp8&tab=Overview,121,145,24,1.2
Acodis IDP Platform,https://azuremarketplace.microsoft.com/en-us/marketplace/apps/acodisag1652787179843.apf2206?exp=ubp8&tab=Overview,20,24,4,1.2
Azure Databricks,https://azuremarketplace.microsoft.com/en-us/marketplace/apps/Microsoft.Databricks?exp=ubp8&tab=Overview,330,389,59,1.2
ArangoDB - the multi-model NoSQL database,https://azuremarketplace.microsoft.com/en-us/marketplace/apps/arangodb.arangodb?exp=ubp8&tab=Overview,73,85,12,1.2
Pobuca Loyalty,https://azuremarketplace.microsoft.com/en-us/marketplace/apps/pobuca.pobucaloyalty?exp=ubp8&tab=Overview,6,7,1,1.2
Alteryx APA Platform,https://azuremarketplace.microsoft.com/en-us/marketplace/apps/alteryx.alteryx-analytics-platform?exp=ubp8&tab=Overview,385,443,58,1.2
BMC Helix on Microsoft Azure,https://azuremarketplace.microsoft.com/en-us/marketplace/apps/bmcsoftware.bmchelix?exp=ubp8&tab=Overview,13,15,2,1.2
StackState,https://azuremarketplace.microsoft.com/en-us/marketplace/apps/xebia-middle-east.ss001?exp=ubp8&tab=Overview,22,27,5,1.2
Adrenalin HCM,https://azuremarketplace.microsoft.com/en-us/marketplace/apps/adrenalinesystemslimited-1160943.adrenalinhcm?exp=ubp8&tab=Overview,11,13,2,1.2
PHEMI Trustworthy Health DataLab,https://azuremarketplace.microsoft.com/en-us/marketplace/apps/phemi-systems-corp.phemi_datalab?exp=ubp8&tab=Overview,5,6,1,1.2
SKU Assortment Optimization,https://azuremarketplace.microsoft.com/en-us/marketplace/apps/neal_analytics.8066ad01-1e61-40cd-bd33-9b86c65fa73a?exp=ubp8&tab=Overview,5,6,1,1.2
Acterys Planning & Analytics For Power BI & Excel,https://azuremarketplace.microsoft.com/en-us/marketplace/apps/managility.acterysfpa?exp=ubp8&tab=Overview,46,54,8,1.2
ClicData,https://azuremarketplace.microsoft.com/en-us/marketplace/apps/clicdata.clicdata-business-intelligence-software?exp=ubp8&tab=Overview,29,35,6,1.2
Compliance Recording AI Analysis Microsoft Teams,https://azuremarketplace.microsoft.com/en-us/marketplace/apps/agatsoftwaredevelopmentltd1592480580416.recording_compliance_anaylsis_1?exp=ubp8&tab=Overview,11,13,2,1.2
Glassbox,https://azuremarketplace.microsoft.com/en-us/marketplace/apps/glassbox.glassbox_solution?exp=ubp8&tab=Overview,518,647,129,1.2
Spring Global - Mobile Retail Execution for Field,https://azuremarketplace.microsoft.com/en-us/marketplace/apps/springglobal.spring-retail-execution?exp=ubp8&tab=Overview,6,7,1,1.2
ARIS Enterprise,https://azuremarketplace.microsoft.com/en-us/marketplace/apps/softwareagusainc.aris_enterprise?exp=ubp8&tab=Overview,22,27,5,1.2
Blackbaud CRM,https://azuremarketplace.microsoft.com/en-us/marketplace/apps/blackbaud-1023404.bbcrm?exp=ubp8&tab=Overview,32,37,5,1.2
Minitab Statistical Software,https://azuremarketplace.microsoft.com/en-us/marketplace/apps/minitabllc1614270009582.mss_20?exp=ubp8&tab=Overview,107,126,19,1.2
eSentire MDR with Microsoft Sentinel,https://azuremarketplace.microsoft.com/en-us/marketplace/apps/esentireinc1602025035350.esentire_sentinel?exp=ubp8&tab=Overview,142,176,34,1.2
Workpuls,https://azuremarketplace.microsoft.com/en-us/marketplace/apps/workpulsinc1613668322757.wp30?exp=ubp8&tab=Overview,152,182,30,1.2
Supermetrics for Azure Storage,https://azuremarketplace.microsoft.com/en-us/marketplace/apps/supermetrics1604042975056.supermetrics-for-azure-storage?exp=ubp8&tab=Overview,594,730,136,1.2
Blackbaud Raiser's Edge NXT,https://azuremarketplace.microsoft.com/en-us/marketplace/apps/blackbaud-1023404.bbrenxt?exp=ubp8&tab=Overview,331,401,70,1.2
CCH Tagetik,https://azuremarketplace.microsoft.com/en-us/marketplace/apps/cch-suretax.cchtagetik?exp=ubp8&tab=Overview,41,49,8,1.2
Supermetrics for Azure Synapse,https://azuremarketplace.microsoft.com/en-us/marketplace/apps/supermetrics1604042975056.supermetrics-for-synapse?exp=ubp8&tab=Overview,594,730,136,1.2
Toucan Guided Analytics,https://azuremarketplace.microsoft.com/en-us/marketplace/apps/toucantoco1605628169815.toucan-toco?exp=ubp8&tab=Overview,101,121,20,1.2
Infinity,https://azuremarketplace.microsoft.com/en-us/marketplace/apps/temenos1581352901657.temenos_infinity?exp=ubp8&tab=Overview,5,6,1,1.2
Whatfix,https://azuremarketplace.microsoft.com/en-us/marketplace/apps/quickotechnosoftlabsprivatelimited1586767592996.whatfix?exp=ubp8&tab=Overview,260,314,54,1.2
iotconnect,https://azuremarketplace.microsoft.com/en-us/marketplace/apps/softwebsolutions-4518310.iotconnect-vm-offer?exp=ubp8&tab=Overview,11,13,2,1.2
Bold BI Enterprise - Multi-tenant,https://azuremarketplace.microsoft.com/en-us/marketplace/apps/syncfusion.bold-bi-enterprise-multi-tenant?exp=ubp8&tab=Overview,47,56,9,1.2
InterSystems IRIS Data Platform,https://azuremarketplace.microsoft.com/en-us/marketplace/apps/intersystems.intersystems-iris-enterprise?exp=ubp8&tab=Overview,39,46,7,1.2
InterSystems IRIS for Health,https://azuremarketplace.microsoft.com/en-us/marketplace/apps/intersystems.intersystems-iris-health-paid?exp=ubp8&tab=Overview,39,46,7,1.2
InterSystems IRIS for Health BYOL,https://azuremarketplace.microsoft.com/en-us/marketplace/apps/intersystems.intersystems-iris-health?exp=ubp8&tab=Overview,39,46,7,1.2
Redgate SQL Provision,https://azuremarketplace.microsoft.com/en-us/marketplace/apps/redgate.redgatesqlprovision?exp=ubp8&tab=Overview,10,12,2,1.2
SQLGate,https://azuremarketplace.microsoft.com/en-us/marketplace/apps/chequer.sqlgate?exp=ubp8&tab=Overview,12,14,2,1.2
Redgate SQL Monitor,https://azuremarketplace.microsoft.com/en-us/marketplace/apps/redgate.redgatesqlmonitor?exp=ubp8&tab=Overview,10,12,2,1.2
Minitab Connect,https://azuremarketplace.microsoft.com/en-us/marketplace/apps/minitabllc1614270009582.connect?exp=ubp8&tab=Overview,16,19,3,1.2
InterSystems IRIS for Health Community Edition,https://azuremarketplace.microsoft.com/en-us/marketplace/apps/intersystems.intersystems-iris-health-community?exp=ubp8&tab=Overview,39,46,7,1.2
InterSystems IRIS Community Edition,https://azuremarketplace.microsoft.com/en-us/marketplace/apps/intersystems.intersystems-iris-community?exp=ubp8&tab=Overview,40,47,7,1.2
ThoughtSpot Search & AI-driven Analytics (BYOL),https://azuremarketplace.microsoft.com/en-us/marketplace/apps/thoughtspot-inc.thoughtspotvirtualmachine?exp=ubp8&tab=Overview,245,297,52,1.2
InterSystems IRIS Data Platform BYOL,https://azuremarketplace.microsoft.com/en-us/marketplace/apps/intersystems.intersystems-iris-byol?exp=ubp8&tab=Overview,40,47,7,1.2
NovaceneAI Platform,https://azuremarketplace.microsoft.com/en-us/marketplace/apps/novaceneaicorp1584102238244.novacene?exp=ubp8&tab=Overview,13,16,3,1.2
Dqlabs Lite,https://azuremarketplace.microsoft.com/en-us/marketplace/apps/intellectyx1582086354194.dqlabs_lite?exp=ubp8&tab=Overview,5,6,1,1.2
ThoughtSpot,https://azuremarketplace.microsoft.com/en-us/marketplace/apps/thoughtspotinc1591838959736.thoughtspot-enterprise-saas?exp=ubp8&tab=Overview,245,297,52,1.2
Algolia Search and Discovery,https://azuremarketplace.microsoft.com/en-us/marketplace/apps/algolia.algolia_search_and_discovery?exp=ubp8&tab=Overview,323,375,52,1.2
Speech,https://azuremarketplace.microsoft.com/en-us/marketplace/apps/Microsoft.CognitiveServicesSpeechServices?exp=ubp8&tab=Overview,77,90,13,1.2
IBM Watson Discovery,https://azuremarketplace.microsoft.com/en-us/marketplace/apps/ibm-usa-ny-armonk-hq-6275750-ibmcloud-asperia.ibm-cloud-pak-for-data-watson-discovery?exp=ubp8&tab=Overview,85,97,12,1.1
Domo for Azure,https://azuremarketplace.microsoft.com/en-us/marketplace/apps/domo_inc.domo?exp=ubp8&tab=Overview,631,700,69,1.1
Azure Data Explorer,https://azuremarketplace.microsoft.com/en-us/marketplace/apps/Microsoft.AzureKusto?exp=ubp8&tab=Overview,39,44,5,1.1
Data Factory,https://azuremarketplace.microsoft.com/en-us/marketplace/apps/Microsoft.DataFactory?exp=ubp8&tab=Overview,562,596,34,1.1
Service Bus,https://azuremarketplace.microsoft.com/en-us/marketplace/apps/Microsoft.ServiceBus?exp=ubp8&tab=Overview,249,263,14,1.1
Azure Machine Learning,https://azuremarketplace.microsoft.com/en-us/marketplace/apps/Microsoft.MachineLearningServices?exp=ubp8&tab=Overview,137,153,16,1.1
Microsoft Purview,https://azuremarketplace.microsoft.com/en-us/marketplace/apps/Microsoft.AzurePurviewGalleryPackage?exp=ubp8&tab=Overview,29,31,2,1.1
Azure CycleCloud,https://azuremarketplace.microsoft.com/en-us/marketplace/apps/azurecyclecloud.azure-cyclecloud?exp=ubp8&tab=Overview,12,13,1,1.1
CockroachDB,https://azuremarketplace.microsoft.com/en-us/marketplace/apps/cockroachlabs1586448087626.cockroachdb-azure?exp=ubp8&tab=Overview,20,21,1,1.1
OneStream,https://azuremarketplace.microsoft.com/en-us/marketplace/apps/onestreamsoftware.onestream_xf?exp=ubp8&tab=Overview,48,52,4,1.1
SonicWall Analytics-BYOL,https://azuremarketplace.microsoft.com/en-us/marketplace/apps/sonicwall-inc.sonicwall-analytics-firewall-byol?exp=ubp8&tab=Overview,115,131,16,1.1
FlexSim for Bonsai,https://azuremarketplace.microsoft.com/en-us/marketplace/apps/flexsimsoftwareproductsinc1662480678262.flexsim-simulator-v1?exp=ubp8&tab=Overview,54,57,3,1.1
Increff,https://azuremarketplace.microsoft.com/en-us/marketplace/apps/nextscmsolutionsprivatelimited1656569813625.increff_1?exp=ubp8&tab=Overview,37,41,4,1.1
FME Platform,https://azuremarketplace.microsoft.com/en-us/marketplace/apps/safesoftwareinc.fme-platform?exp=ubp8&tab=Overview,14,16,2,1.1
Kapiche,https://azuremarketplace.microsoft.com/en-us/marketplace/apps/kapiche.kapiche-saas?exp=ubp8&tab=Overview,36,39,3,1.1
IRONSCALES,https://azuremarketplace.microsoft.com/en-us/marketplace/apps/iron-scales.ironscales?exp=ubp8&tab=Overview,21,24,3,1.1
InRule,https://azuremarketplace.microsoft.com/en-us/marketplace/apps/inruletechnology-1043512.inrulesaas?exp=ubp8&tab=Overview,57,65,8,1.1
Applitools Eyes for Azure,https://azuremarketplace.microsoft.com/en-us/marketplace/apps/applitools-5070078.applitoolseyes?exp=ubp8&tab=Overview,43,47,4,1.1
ArcGIS Business Analyst Web App,https://azuremarketplace.microsoft.com/en-us/marketplace/apps/esri.arcgis-business-analyst-web?exp=ubp8&tab=Overview,18,19,1,1.1
Automated Feedback by FeedbackFruits,https://azuremarketplace.microsoft.com/en-us/marketplace/apps/feedbackfruits1589372217712.feedbackfruits_automated_feedback?exp=ubp8&tab=Overview,12,13,1,1.1
Moogsoft AIOps,https://azuremarketplace.microsoft.com/en-us/marketplace/apps/moogsoft.moogsoft-trial?exp=ubp8&tab=Overview,35,38,3,1.1
Piwik PRO Analytics Suite,https://azuremarketplace.microsoft.com/en-us/marketplace/apps/piwikprospzoo-5043373.enterpriseanalyticsandtagmanagementplatform?exp=ubp8&tab=Overview,22,25,3,1.1
Real-Time Digital Operations Management for Azure,https://azuremarketplace.microsoft.com/en-us/marketplace/apps/pagerduty.pagerdutysaas?exp=ubp8&tab=Overview,792,882,90,1.1
CloudPilot,https://azuremarketplace.microsoft.com/en-us/marketplace/apps/cloudatlasinc.36d534d9-ab47-4cd8-93d3-2be7df682782?exp=ubp8&tab=Overview,7,8,1,1.1
Captain Up,https://azuremarketplace.microsoft.com/en-us/marketplace/apps/captain-up.5173591?exp=ubp8&tab=Overview,9,10,1,1.1
Snowflake,https://azuremarketplace.microsoft.com/en-us/marketplace/apps/snowflake.snowflake_contact_me?exp=ubp8&tab=Overview,442,496,54,1.1
Interactive Document by FeedbackFruits,https://azuremarketplace.microsoft.com/en-us/marketplace/apps/feedbackfruits1589372217712.feedbackfruits_interactive_document?exp=ubp8&tab=Overview,12,13,1,1.1
Interactive Audio by FeedbackFruits,https://azuremarketplace.microsoft.com/en-us/marketplace/apps/feedbackfruits1589372217712.feedbackfruits_interactive_audio?exp=ubp8&tab=Overview,12,13,1,1.1
Interactive Presentation by FeedbackFruits,https://azuremarketplace.microsoft.com/en-us/marketplace/apps/feedbackfruits1589372217712.feedbackfruits_interactive_presentation?exp=ubp8&tab=Overview,12,13,1,1.1
Interactive Video by FeedbackFruits,https://azuremarketplace.microsoft.com/en-us/marketplace/apps/feedbackfruits1589372217712.feedbackfruits_interactive_video?exp=ubp8&tab=Overview,12,13,1,1.1
Comprehension by FeedbackFruits,https://azuremarketplace.microsoft.com/en-us/marketplace/apps/feedbackfruits1589372217712.feedbackfruits_comprehension?exp=ubp8&tab=Overview,12,13,1,1.1
Labelbox,https://azuremarketplace.microsoft.com/en-us/marketplace/apps/labelbox1639767532462.labelbox?exp=ubp8&tab=Overview,27,30,3,1.1
FeedbackFruits Tool Suite for Higher Ed,https://azuremarketplace.microsoft.com/en-us/marketplace/apps/feedbackfruits1586515325519.feedbackfruits_he?exp=ubp8&tab=Overview,12,13,1,1.1
FeedbackFruits Tool Suite for K12,https://azuremarketplace.microsoft.com/en-us/marketplace/apps/feedbackfruits1586515325519.feedbackfruits_k12?exp=ubp8&tab=Overview,12,13,1,1.1
ArcGIS Online,https://azuremarketplace.microsoft.com/en-us/marketplace/apps/esri.sol-14320-fil?exp=ubp8&tab=Overview,168,184,16,1.1
Peer Review by FeedbackFruits,https://azuremarketplace.microsoft.com/en-us/marketplace/apps/feedbackfruits1589372217712.feedbackfruits_peer_review?exp=ubp8&tab=Overview,12,13,1,1.1
Skill Review by FeedbackFruits,https://azuremarketplace.microsoft.com/en-us/marketplace/apps/feedbackfruits1589372217712.feedbackfruits_skill_review?exp=ubp8&tab=Overview,12,13,1,1.1
FeedbackFruits Tool Suite,https://azuremarketplace.microsoft.com/en-us/marketplace/apps/feedbackfruits1589372217712.feedbackfruits_suite_of_tools?exp=ubp8&tab=Overview,12,13,1,1.1
Informatica Data Quality,https://azuremarketplace.microsoft.com/en-us/marketplace/apps/informatica.informatica-idq-1041?exp=ubp8&tab=Overview,11,12,1,1.1
Informatica Enterprise Data Catalog,https://azuremarketplace.microsoft.com/en-us/marketplace/apps/informatica.informaica-edc-1041?exp=ubp8&tab=Overview,19,21,2,1.1
Blue Yonder Warehouse Management,https://azuremarketplace.microsoft.com/en-us/marketplace/apps/jdasoftware-global.jda_warehouse_management_appsource?exp=ubp8&tab=Overview,17,19,2,1.1
PPM Express,https://azuremarketplace.microsoft.com/en-us/marketplace/apps/ppmexpresscorporation.ppm-express?exp=ubp8&tab=Overview,7,8,1,1.1
XLSTAT Basic,https://azuremarketplace.microsoft.com/en-us/marketplace/apps/addinsoft.xlstat-basic?exp=ubp8&tab=Overview,37,41,4,1.1
IQVIA Research Management Platform,https://azuremarketplace.microsoft.com/en-us/marketplace/apps/iqviainc1620065739561.sol-63435-ihs?exp=ubp8&tab=Overview,13,14,1,1.1
SmartOffice,https://azuremarketplace.microsoft.com/en-us/marketplace/apps/avnetinc.smart_office?exp=ubp8&tab=Overview,28,32,4,1.1
i-Sight,https://azuremarketplace.microsoft.com/en-us/marketplace/apps/i-sight.i-sight?exp=ubp8&tab=Overview,47,53,6,1.1
XLSTAT Basic+,https://azuremarketplace.microsoft.com/en-us/marketplace/apps/addinsoft.xlstat-base?exp=ubp8&tab=Overview,37,41,4,1.1
XLSTAT Premium,https://azuremarketplace.microsoft.com/en-us/marketplace/apps/addinsoft.xlstat-premium?exp=ubp8&tab=Overview,37,41,4,1.1
Mentionlytics,https://azuremarketplace.microsoft.com/en-us/marketplace/apps/mentionlyticsltd.mentionlytics?exp=ubp8&tab=Overview,65,73,8,1.1
XLSTAT Sensory,https://azuremarketplace.microsoft.com/en-us/marketplace/apps/addinsoft.xlstat-sensory?exp=ubp8&tab=Overview,37,41,4,1.1
XLSTAT Life Sciences,https://azuremarketplace.microsoft.com/en-us/marketplace/apps/addinsoft.xlstat-biomed?exp=ubp8&tab=Overview,37,41,4,1.1
XLSTAT Marketing,https://azuremarketplace.microsoft.com/en-us/marketplace/apps/addinsoft.xlstat-marketing?exp=ubp8&tab=Overview,37,41,4,1.1
XLSTAT Forecasting,https://azuremarketplace.microsoft.com/en-us/marketplace/apps/addinsoft.xlstat-forecast?exp=ubp8&tab=Overview,37,41,4,1.1
XLSTAT Quality,https://azuremarketplace.microsoft.com/en-us/marketplace/apps/addinsoft.xlstat-quality?exp=ubp8&tab=Overview,37,41,4,1.1
Armorblox for Microsoft Sentinel,https://azuremarketplace.microsoft.com/en-us/marketplace/apps/armorblox1601081599926.armorblox_sentinel_1?exp=ubp8&tab=Overview,12,13,1,1.1
Sumo Logic for Azure Audit,https://azuremarketplace.microsoft.com/en-us/marketplace/apps/sumologic.sumo-logic-azure-audit-logs?exp=ubp8&tab=Overview,268,282,14,1.1
Moogsoft AIOps Trial,https://azuremarketplace.microsoft.com/en-us/marketplace/apps/moogsoft.moogsoft-aiops?exp=ubp8&tab=Overview,35,38,3,1.1
ArcGIS Desktop,https://azuremarketplace.microsoft.com/en-us/marketplace/apps/esri.arcgis-desktop?exp=ubp8&tab=Overview,308,331,23,1.1
Varnish Custom Statistics,https://azuremarketplace.microsoft.com/en-us/marketplace/apps/varnish.varnish-custom-statistics?exp=ubp8&tab=Overview,85,96,11,1.1
Sumo Logic for Azure Web Apps,https://azuremarketplace.microsoft.com/en-us/marketplace/apps/sumologic.sumo-logic-azure-webapp?exp=ubp8&tab=Overview,268,282,14,1.1
AWARE,https://azuremarketplace.microsoft.com/en-us/marketplace/apps/citymaasio1582729509137.aware?exp=ubp8&tab=Overview,15,16,1,1.1
Relex Work,https://azuremarketplace.microsoft.com/en-us/marketplace/apps/relexsolutions.sol-40727-ogb?exp=ubp8&tab=Overview,14,16,2,1.1
Engagely Voice AI Bot,https://azuremarketplace.microsoft.com/en-us/marketplace/apps/exponentiadatalab1590053244292.engagely_voice_ai_solution_1?exp=ubp8&tab=Overview,17,18,1,1.1
LivePerson Conversational Cloud,https://azuremarketplace.microsoft.com/en-us/marketplace/apps/livepersoninc1588859823179.liveperson_conversational_cloud_cm?exp=ubp8&tab=Overview,119,133,14,1.1
Unity,https://azuremarketplace.microsoft.com/en-us/marketplace/apps/codafication1578973662846.unity_cloud?exp=ubp8&tab=Overview,316,336,20,1.1
MATLAB (BYOL),https://azuremarketplace.microsoft.com/en-us/marketplace/apps/mathworks-inc.matlab-byol?exp=ubp8&tab=Overview,667,724,57,1.1
Dataiku Enterprise Ready AI,https://azuremarketplace.microsoft.com/en-us/marketplace/apps/dataiku.dataiku-dss-azure?exp=ubp8&tab=Overview,34,37,3,1.1
Informatica Intelligent Data Management Cloud,https://azuremarketplace.microsoft.com/en-us/marketplace/apps/informatica.annualiics?exp=ubp8&tab=Overview,248,264,16,1.1
Azure Health Bot,https://azuremarketplace.microsoft.com/en-us/marketplace/apps/Microsoft.HealthBot?exp=ubp8&tab=Overview,17,18,1,1.1
Language Understanding,https://azuremarketplace.microsoft.com/en-us/marketplace/apps/Microsoft.CognitiveServicesLUISAllInOne?exp=ubp8&tab=Overview,12,13,1,1.1
Translator,https://azuremarketplace.microsoft.com/en-us/marketplace/apps/Microsoft.CognitiveServicesTextTranslation?exp=ubp8&tab=Overview,295,312,17,1.1
Azure CDN Core Analytics,https://azuremarketplace.microsoft.com/en-us/marketplace/apps/Microsoft.AzureCdnCoreAnalytics?exp=ubp8&tab=Overview,21,24,3,1.1
Board – The Intelligent Planning Platform,https://azuremarketplace.microsoft.com/en-us/marketplace/apps/board-international.board-cloud?exp=ubp8&tab=Overview,247,265,18,1.1
Hyperscience Intelligent Document Processing,https://azuremarketplace.microsoft.com/en-us/marketplace/apps/hyperscience1598031518245.hyperscience?exp=ubp8&tab=Overview,15,16,1,1.1
Iamprogrez Skillbuilder for Minecraft,https://azuremarketplace.microsoft.com/en-us/marketplace/apps/iamprogrez.skillbuilder-for-minecraft?exp=ubp8&tab=Overview,2,2,0,1.0
Air Optimizer,https://azuremarketplace.microsoft.com/en-us/marketplace/apps/amphoricatechnologiesltd1666090299586.airoptimizer1?exp=ubp8&tab=Overview,1,1,0,1.0
OneConnect by OnePlan,https://azuremarketplace.microsoft.com/en-us/marketplace/apps/oneplanllc.oneconnect?exp=ubp8&tab=Overview,1,1,0,1.0
Dash Enterprise,https://azuremarketplace.microsoft.com/en-us/marketplace/apps/plotlytechnologiesinc1579709143597.de01?exp=ubp8&tab=Overview,33,34,1,1.0
Terraform on Ubuntu 20.04,https://azuremarketplace.microsoft.com/en-us/marketplace/apps/apps-4-rent.terraform-on-ubuntu2004?exp=ubp8&tab=Overview,3,3,0,1.0
Rust on Ubuntu18.04LTS,https://azuremarketplace.microsoft.com/en-us/marketplace/apps/apps-4-rent.rust-on-ubuntu18?exp=ubp8&tab=Overview,1,1,0,1.0
Drupal on Ubuntu 18.04,https://azuremarketplace.microsoft.com/en-us/marketplace/apps/apps-4-rent.drupal-on-ubuntu1804?exp=ubp8&tab=Overview,1,1,0,1.0
Golang on Debian10,https://azuremarketplace.microsoft.com/en-us/marketplace/apps/apps-4-rent.golang-on-debian10?exp=ubp8&tab=Overview,2,2,0,1.0
Puppet Bolt on Windows Server 2016,https://azuremarketplace.microsoft.com/en-us/marketplace/apps/apps-4-rent.puppet-bolt-on-windows2016?exp=ubp8&tab=Overview,1,1,0,1.0
Ripple on Ubuntu20.04LTS,https://azuremarketplace.microsoft.com/en-us/marketplace/apps/apps-4-rent.ripple-on-ubuntu20?exp=ubp8&tab=Overview,1,1,0,1.0
Ripple on Debian11,https://azuremarketplace.microsoft.com/en-us/marketplace/apps/apps-4-rent.ripple-on-debian11?exp=ubp8&tab=Overview,1,1,0,1.0
Weka on CentOS 7.9,https://azuremarketplace.microsoft.com/en-us/marketplace/apps/apps-4-rent.weka-on-centos7?exp=ubp8&tab=Overview,1,1,0,1.0
Eve on Centos7.9,https://azuremarketplace.microsoft.com/en-us/marketplace/apps/apps-4-rent.eve-on-centos7?exp=ubp8&tab=Overview,1,1,0,1.0
Ruby on Debian11,https://azuremarketplace.microsoft.com/en-us/marketplace/apps/apps-4-rent.ruby-on-debian11?exp=ubp8&tab=Overview,1,1,0,1.0
Weka on Ubuntu 18.04,https://azuremarketplace.microsoft.com/en-us/marketplace/apps/apps-4-rent.weka-on-ubuntu18?exp=ubp8&tab=Overview,1,1,0,1.0
Edart - Education Data Analysis and Reporting Tool,https://azuremarketplace.microsoft.com/en-us/marketplace/apps/bitnetsolutionsltd1579090789104.2020?exp=ubp8&tab=Overview,1,1,0,1.0
SharpCloud Subscriptions,https://azuremarketplace.microsoft.com/en-us/marketplace/apps/sharpcloudsoftwareltd1588172021849.sharpcloud_fullsubscription?exp=ubp8&tab=Overview,3,3,0,1.0
WellView,https://azuremarketplace.microsoft.com/en-us/marketplace/apps/pelotoncomputerenterprises.pelotonwellview?exp=ubp8&tab=Overview,17,17,0,1.0
GEP SMART Catalog Management,https://azuremarketplace.microsoft.com/en-us/marketplace/apps/gep.gep_catalogmanagement?exp=ubp8&tab=Overview,23,22,-1,1.0
Puppet Bolt on Ubuntu 20.04,https://azuremarketplace.microsoft.com/en-us/marketplace/apps/apps-4-rent.puppetbolt-on-ubuntu2004?exp=ubp8&tab=Overview,2,2,0,1.0
Puppet Bolt on Debian 11,https://azuremarketplace.microsoft.com/en-us/marketplace/apps/apps-4-rent.puppetbolt-on-debian11?exp=ubp8&tab=Overview,2,2,0,1.0
Puppet Bolt on Debian 10,https://azuremarketplace.microsoft.com/en-us/marketplace/apps/apps-4-rent.puppetbolt-on-debian10?exp=ubp8&tab=Overview,4,4,0,1.0
Puppet Bolt on Ubuntu 18.04,https://azuremarketplace.microsoft.com/en-us/marketplace/apps/apps-4-rent.puppetbolt-on-ubuntu1804?exp=ubp8&tab=Overview,2,2,0,1.0
Omniscope Evo,https://azuremarketplace.microsoft.com/en-us/marketplace/apps/visokiouklimited1661943152060.visokio-omniscope?exp=ubp8&tab=Overview,10,10,0,1.0
Nagios Core on Centos 7.9,https://azuremarketplace.microsoft.com/en-us/marketplace/apps/apps-4-rent.nagios-core-on-centos79?exp=ubp8&tab=Overview,1,1,0,1.0
Rstudio on Windows Server 2016,https://azuremarketplace.microsoft.com/en-us/marketplace/apps/apps-4-rent.rstudio-on-windows2016?exp=ubp8&tab=Overview,1,1,0,1.0
Puppet Bolt on Windows Server 2022,https://azuremarketplace.microsoft.com/en-us/marketplace/apps/apps-4-rent.puppetbolt-on-windows2022?exp=ubp8&tab=Overview,1,1,0,1.0
CakePHP on Windows Server 2022,https://azuremarketplace.microsoft.com/en-us/marketplace/apps/apps-4-rent.cakephp-on-windows2022?exp=ubp8&tab=Overview,1,1,0,1.0
Theano on Windows Server 2019,https://azuremarketplace.microsoft.com/en-us/marketplace/apps/apps-4-rent.theano-on-windows2019?exp=ubp8&tab=Overview,2,2,0,1.0
CakePHP on Windows Server 2019,https://azuremarketplace.microsoft.com/en-us/marketplace/apps/apps-4-rent.cakephp-on-windows2019?exp=ubp8&tab=Overview,1,1,0,1.0
RStudio on Ubuntu20.04TS,https://azuremarketplace.microsoft.com/en-us/marketplace/apps/apps-4-rent.rstudio-on-ubuntu20?exp=ubp8&tab=Overview,1,1,0,1.0
RStudio on Windows Server 2022,https://azuremarketplace.microsoft.com/en-us/marketplace/apps/apps-4-rent.rstudio-on-windows2022?exp=ubp8&tab=Overview,3,3,0,1.0
RStudio on Debian10,https://azuremarketplace.microsoft.com/en-us/marketplace/apps/apps-4-rent.rstudio-on-debian10?exp=ubp8&tab=Overview,1,1,0,1.0
Pandas on Debian10,https://azuremarketplace.microsoft.com/en-us/marketplace/apps/apps-4-rent.pandas-on-debian10?exp=ubp8&tab=Overview,2,2,0,1.0
RStudio on Debian11,https://azuremarketplace.microsoft.com/en-us/marketplace/apps/apps-4-rent.rstudio-on-debian11?exp=ubp8&tab=Overview,1,1,0,1.0
Pandas on Ubuntu18.04LTS,https://azuremarketplace.microsoft.com/en-us/marketplace/apps/apps-4-rent.pandas-on-ubuntu18?exp=ubp8&tab=Overview,1,1,0,1.0
B2Metric Analytics,https://azuremarketplace.microsoft.com/en-us/marketplace/apps/b2metric1661057686324.b2metric_analytics?exp=ubp8&tab=Overview,1,1,0,1.0
Automation Hero,https://azuremarketplace.microsoft.com/en-us/marketplace/apps/automationheroinc1656071298492.automationhero_1?exp=ubp8&tab=Overview,1,1,0,1.0
Run:ai Quickstart,https://azuremarketplace.microsoft.com/en-us/marketplace/apps/runailabsltd1647779544073.runai-quickstart?exp=ubp8&tab=Overview,1,1,0,1.0
Eve on Ubuntu20.04LTS,https://azuremarketplace.microsoft.com/en-us/marketplace/apps/apps-4-rent.eve-on-ubuntu20?exp=ubp8&tab=Overview,1,1,0,1.0
Azure FarmBeats (Preview),https://azuremarketplace.microsoft.com/en-us/marketplace/apps/microsoftfarmbeats.microsoft_farmbeats?exp=ubp8&tab=Overview,1,1,0,1.0
GeoServer,https://azuremarketplace.microsoft.com/en-us/marketplace/apps/apps-4-rent.geoserver-windows-server-2016?exp=ubp8&tab=Overview,10,10,0,1.0
Velocity,https://azuremarketplace.microsoft.com/en-us/marketplace/apps/kagool.velocity-kagool?exp=ubp8&tab=Overview,4,4,0,1.0
ThingsBoard Professional Edition BYOL,https://azuremarketplace.microsoft.com/en-us/marketplace/apps/things-board.tb-pe-byol?exp=ubp8&tab=Overview,5,5,0,1.0
H2O AI Cloud Platform,https://azuremarketplace.microsoft.com/en-us/marketplace/apps/h2o-ai.haic_ai_platform?exp=ubp8&tab=Overview,24,24,0,1.0
Graviti Unstructured Data Platform,https://azuremarketplace.microsoft.com/en-us/marketplace/apps/gravititechnologiesinc1653497515465.graviti_contact_me?exp=ubp8&tab=Overview,1,1,0,1.0
Virtual AI based incident auditor,https://azuremarketplace.microsoft.com/en-us/marketplace/apps/enzyme1654706154542.ai_incident_predictor?exp=ubp8&tab=Overview,1,1,0,1.0
BioCatch for FSI Cloud,https://azuremarketplace.microsoft.com/en-us/marketplace/apps/biocatch.biocatch_fsicloud?exp=ubp8&tab=Overview,2,2,0,1.0
Semarchy xDM,https://azuremarketplace.microsoft.com/en-us/marketplace/apps/semarchy.xdm-solution?exp=ubp8&tab=Overview,21,21,0,1.0
Flexera IT Visibility,https://azuremarketplace.microsoft.com/en-us/marketplace/apps/flexerasoftware.flexera_itvisibility?exp=ubp8&tab=Overview,39,39,0,1.0
HealthEM.AI Cohort Builder Product by Tredence,https://azuremarketplace.microsoft.com/en-us/marketplace/apps/tredenceinc1629971447744.tredence_healthem_ai_cohort_builder?exp=ubp8&tab=Overview,2,2,0,1.0
Automated Campaigns: AI Voice Assistant,https://azuremarketplace.microsoft.com/en-us/marketplace/apps/borndigitalsro1621338534355.outbound_campaigns_voice_assistant?exp=ubp8&tab=Overview,1,1,0,1.0
Personetics Engage SaaS,https://azuremarketplace.microsoft.com/en-us/marketplace/apps/personeticstechnologiesltd.personetics_engage_saas_1?exp=ubp8&tab=Overview,1,1,0,1.0
Azure Cost Management,https://azuremarketplace.microsoft.com/en-us/marketplace/apps/venzoas1591803357563.acd?exp=ubp8&tab=Overview,1,1,0,1.0
Azure HDInsight,https://azuremarketplace.microsoft.com/en-us/marketplace/apps/Microsoft.HDInsightCluster?exp=ubp8&tab=Overview,182,184,2,1.0
Data Lake Storage Gen1,https://azuremarketplace.microsoft.com/en-us/marketplace/apps/Microsoft.AzureDataLakeStore?exp=ubp8&tab=Overview,105,105,0,1.0
PBI Portal,https://azuremarketplace.microsoft.com/en-us/marketplace/apps/devscope-1156626.powerbi_portal?exp=ubp8&tab=Overview,2,2,0,1.0
Event Hubs,https://azuremarketplace.microsoft.com/en-us/marketplace/apps/Microsoft.EventHub?exp=ubp8&tab=Overview,108,108,0,1.0
Dynatrace Software Intelligence Platform,https://azuremarketplace.microsoft.com/en-us/marketplace/apps/dynatrace.dynatrace-apm?exp=ubp8&tab=Overview,999,999,0,1.0
Denodo Professional (Hourly),https://azuremarketplace.microsoft.com/en-us/marketplace/apps/denodo.denodo-8_0-pro-vm-payg?exp=ubp8&tab=Overview,34,35,1,1.0
Netwrix PolicyPak,https://azuremarketplace.microsoft.com/en-us/marketplace/apps/netwrixcorporation1638479829162.policypak?exp=ubp8&tab=Overview,37,37,0,1.0
Snowflake Data Cloud: Mobilize your data globally,https://azuremarketplace.microsoft.com/en-us/marketplace/apps/snowflake.data_cloud?exp=ubp8&tab=Overview,4,4,0,1.0
ContentKeeper,https://azuremarketplace.microsoft.com/en-us/marketplace/apps/imperosolutionsltd1586255668947.contentkeeper?exp=ubp8&tab=Overview,2,2,0,1.0
HPE OneView for Azure Log Analytics (v1.4.0),https://azuremarketplace.microsoft.com/en-us/marketplace/apps/hpe.HPE-OneView-for-Log-Analytics?exp=ubp8&tab=Overview,2,2,0,1.0
CallCabinet Compliance Call Recording & Analytics,https://azuremarketplace.microsoft.com/en-us/marketplace/apps/callcabinetcorporation1584393576335.atmos?exp=ubp8&tab=Overview,1,1,0,1.0
Chartnado,https://azuremarketplace.microsoft.com/en-us/marketplace/apps/powdersoftwareinc1650490509965.chartnado_prod_001?exp=ubp8&tab=Overview,1,1,0,1.0
Saleskube,https://azuremarketplace.microsoft.com/en-us/marketplace/apps/samishtiinfotechprivatelimited1630649458320.flashkube_sales?exp=ubp8&tab=Overview,1,1,0,1.0
Analysis Services,https://azuremarketplace.microsoft.com/en-us/marketplace/apps/Microsoft.AnalysisServices?exp=ubp8&tab=Overview,102,102,0,1.0
Microsoft Server Operating Systems Preview,https://azuremarketplace.microsoft.com/en-us/marketplace/apps/microsoftwindowsserver.microsoftserveroperatingsystems-previews?exp=ubp8&tab=Overview,2,2,0,1.0
Enigma2.0,https://azuremarketplace.microsoft.com/en-us/marketplace/apps/xaanaai1595611306073.enigma2?exp=ubp8&tab=Overview,1,1,0,1.0
Customer Cosmos by Tredence | AI-enabled Customer 360 Data Platform,https://azuremarketplace.microsoft.com/en-us/marketplace/apps/tredenceinc1629971447744.customer360_cosmos_saas?exp=ubp8&tab=Overview,1,1,0,1.0
DeMT™ Estimate API,https://azuremarketplace.microsoft.com/en-us/marketplace/apps/tausbv1667479865417.demt_qe_api_001?exp=ubp8&tab=Overview,1,1,0,1.0
Open Data Blend Datasets,https://azuremarketplace.microsoft.com/en-us/marketplace/apps/nimblelearnltd1629303137039.open-data-blend?exp=ubp8&tab=Overview,2,2,0,1.0
Windows Server OS Monitoring [Preview],https://azuremarketplace.microsoft.com/en-us/marketplace/apps/LumagateAS.LumagateASWindowsServerOS?exp=ubp8&tab=Overview,1,1,0,1.0
Upsolver,https://azuremarketplace.microsoft.com/en-us/marketplace/apps/upsolver1594188634150.upsolver?exp=ubp8&tab=Overview,14,14,0,1.0
PostgreSQL on Windows Server 2019,https://azuremarketplace.microsoft.com/en-us/marketplace/apps/apps-4-rent.postgresql-windows-server-2019?exp=ubp8&tab=Overview,10,10,0,1.0
Azure Data Science Hub - DSVM,https://azuremarketplace.microsoft.com/en-us/marketplace/apps/ntegralinc1586961136942.ntg_azure_dsvm_1_0_0?exp=ubp8&tab=Overview,1,1,0,1.0
Cisco Catalyst 8000V Edge Software - Solution Deployment,https://azuremarketplace.microsoft.com/en-us/marketplace/apps/cisco.cisco-c8000v-basic-template?exp=ubp8&tab=Overview,2,2,0,1.0
Informatica PowerCenter,https://azuremarketplace.microsoft.com/en-us/marketplace/apps/informatica.powercenter-1041?exp=ubp8&tab=Overview,67,69,2,1.0
H2O VM,https://azuremarketplace.microsoft.com/en-us/marketplace/apps/h2o-ai.h2o-vm?exp=ubp8&tab=Overview,24,24,0,1.0
AVEVA Edge,https://azuremarketplace.microsoft.com/en-us/marketplace/apps/aveva1.aveva_edge_scada?exp=ubp8&tab=Overview,12,12,0,1.0
DeMT™ Translate,https://azuremarketplace.microsoft.com/en-us/marketplace/apps/tausbv1667479865417.demt_tr_001?exp=ubp8&tab=Overview,1,1,0,1.0
AMG - Adoption 365,https://azuremarketplace.microsoft.com/en-us/marketplace/apps/the-data-prosnet1600347600790.m365adoptionmodule?exp=ubp8&tab=Overview,1,1,0,1.0
DomainTools Iris Investigate for Microsoft Sentinel,https://azuremarketplace.microsoft.com/en-us/marketplace/apps/domaintoolsllc1647901527537.domaintools-iris-investigate?exp=ubp8&tab=Overview,1,1,0,1.0
Qard,https://azuremarketplace.microsoft.com/en-us/marketplace/apps/qard1655287449918.qard?exp=ubp8&tab=Overview,2,2,0,1.0
Zetaris - Federated Query Engine (SaaS),https://azuremarketplace.microsoft.com/en-us/marketplace/apps/zetarisptyltd1653890360235.zetaris_the_networked_data_platform?exp=ubp8&tab=Overview,1,1,0,1.0
Aspen SeisEarth,https://azuremarketplace.microsoft.com/en-us/marketplace/apps/aspentechnologyhq-1353108.aspen_sse_seisearth?exp=ubp8&tab=Overview,3,3,0,1.0
ArcGIS Insights,https://azuremarketplace.microsoft.com/en-us/marketplace/apps/esri.arcgis-insights?exp=ubp8&tab=Overview,15,15,0,1.0
KNIME on Windows Server 2019,https://azuremarketplace.microsoft.com/en-us/marketplace/apps/apps-4-rent.knime-on-windows2019?exp=ubp8&tab=Overview,1,1,0,1.0
Postgresql on Debian11,https://azuremarketplace.microsoft.com/en-us/marketplace/apps/apps-4-rent.postgresql-on-debian11?exp=ubp8&tab=Overview,1,1,0,1.0
Postgresql on Ubuntu18.04TS,https://azuremarketplace.microsoft.com/en-us/marketplace/apps/apps-4-rent.postgresql-on-ubuntu18?exp=ubp8&tab=Overview,1,1,0,1.0
Postgresql on Debian10,https://azuremarketplace.microsoft.com/en-us/marketplace/apps/apps-4-rent.postgresql-on-debian10?exp=ubp8&tab=Overview,2,2,0,1.0
KNIME on Windows Server 2016,https://azuremarketplace.microsoft.com/en-us/marketplace/apps/apps-4-rent.knime-on-windows2016?exp=ubp8&tab=Overview,1,1,0,1.0
GEP SMART Sourcing,https://azuremarketplace.microsoft.com/en-us/marketplace/apps/gep.gep_sourcing?exp=ubp8&tab=Overview,23,22,-1,1.0
TerminusDB In-Memory Document Graph Database,https://azuremarketplace.microsoft.com/en-us/marketplace/apps/terminusdb1606769310168.terminusdb_vm?exp=ubp8&tab=Overview,1,1,0,1.0
GEP SMART Contract Management,https://azuremarketplace.microsoft.com/en-us/marketplace/apps/gep.gep_contracts?exp=ubp8&tab=Overview,23,22,-1,1.0
Cherwell Asset Management,https://azuremarketplace.microsoft.com/en-us/marketplace/apps/cherwell.express-software-manager?exp=ubp8&tab=Overview,16,16,0,1.0
Batch AI Service (Retired),https://azuremarketplace.microsoft.com/en-us/marketplace/apps/Microsoft.BatchAI?exp=ubp8&tab=Overview,4,4,0,1.0
Semarchy xDM - Quick Start VM,https://azuremarketplace.microsoft.com/en-us/marketplace/apps/semarchy.xdm?exp=ubp8&tab=Overview,21,21,0,1.0
Glances on Ubuntu20.04LTS,https://azuremarketplace.microsoft.com/en-us/marketplace/apps/apps-4-rent.glances-on-ubuntu20?exp=ubp8&tab=Overview,1,1,0,1.0
Toloka Data Labeling Platform and Adaptive AutoML,https://azuremarketplace.microsoft.com/en-us/marketplace/apps/tolokaai1653050813339.toloka_e-commerce?exp=ubp8&tab=Overview,1,1,0,1.0
Tesseract on Centos7.9,https://azuremarketplace.microsoft.com/en-us/marketplace/apps/apps-4-rent.tesseract-on-centos7?exp=ubp8&tab=Overview,1,1,0,1.0
Rust on Centos7.9,https://azuremarketplace.microsoft.com/en-us/marketplace/apps/apps-4-rent.rust-on-centos7?exp=ubp8&tab=Overview,1,1,0,1.0
Tesseract on Ubuntu20.04LTS,https://azuremarketplace.microsoft.com/en-us/marketplace/apps/apps-4-rent.tesseract-on-ubuntu20?exp=ubp8&tab=Overview,1,1,0,1.0
Canvass AI Platform,https://azuremarketplace.microsoft.com/en-us/marketplace/apps/canvassanalytics.canvass-ai-platform?exp=ubp8&tab=Overview,3,3,0,1.0
HMX Corporation Tax Intelligence System,https://azuremarketplace.microsoft.com/en-us/marketplace/apps/smartcloud.smartcloud-tax-intelligence-trial-app?exp=ubp8&tab=Overview,1,1,0,1.0
Predictive_Analytics_Marketing_Supply-Planning,https://azuremarketplace.microsoft.com/en-us/marketplace/apps/singular_intelligence.singular_intelligence_ai?exp=ubp8&tab=Overview,1,1,0,1.0
Segmentify,https://azuremarketplace.microsoft.com/en-us/marketplace/apps/segmentify-5042105.register?exp=ubp8&tab=Overview,62,63,1,1.0
Speechmatics | Speech API | Most Accurate and Inclusive Speech Technology,https://azuremarketplace.microsoft.com/en-us/marketplace/apps/speechmatics.speechmatics-v2-saas?exp=ubp8&tab=Overview,1,1,0,1.0
Smati,https://azuremarketplace.microsoft.com/en-us/marketplace/apps/hxperience.smati?exp=ubp8&tab=Overview,1,1,0,1.0
THEMIS IA,https://azuremarketplace.microsoft.com/en-us/marketplace/apps/heluxsystems.001?exp=ubp8&tab=Overview,2,2,0,1.0
Digital Contracting SDK by Signzy,https://azuremarketplace.microsoft.com/en-us/marketplace/apps/signzy1582699295075.signzy_api?exp=ubp8&tab=Overview,1,1,0,1.0
UiPath Process Mining 22.4,https://azuremarketplace.microsoft.com/en-us/marketplace/apps/uipath-5054924.uipath_process_mining?exp=ubp8&tab=Overview,69,70,1,1.0
Optelos Enterprise Asset Advisor,https://azuremarketplace.microsoft.com/en-us/marketplace/apps/optelos1580397055826.enterprise_asset_advisor?exp=ubp8&tab=Overview,1,1,0,1.0
Symanto Insights Platform,https://azuremarketplace.microsoft.com/en-us/marketplace/apps/symantoresearchgmbhcokg1579778781216.sol-5286-zd?exp=ubp8&tab=Overview,2,2,0,1.0
Visual Search from Particular Audience,https://azuremarketplace.microsoft.com/en-us/marketplace/apps/particularaudience1581409218495.pa-vs?exp=ubp8&tab=Overview,1,1,0,1.0
Intelli-Bot,https://azuremarketplace.microsoft.com/en-us/marketplace/apps/apar.intelli-bot?exp=ubp8&tab=Overview,1,1,0,1.0
Kespry Perception Analytics,https://azuremarketplace.microsoft.com/en-us/marketplace/apps/kespryinc.kespry_perception_analytics?exp=ubp8&tab=Overview,4,4,0,1.0
Beamy - Tech Intelligence Platform,https://azuremarketplace.microsoft.com/en-us/marketplace/apps/beamy.beamy?exp=ubp8&tab=Overview,1,1,0,1.0
BotCore - Enterprise Chatbot Builder,https://azuremarketplace.microsoft.com/en-us/marketplace/apps/acuvatesoftwareltd-3515073.botcore?exp=ubp8&tab=Overview,1,1,0,1.0
IT Helpdesk Bot,https://azuremarketplace.microsoft.com/en-us/marketplace/apps/acuvatesoftwareltd-3515073.itbot?exp=ubp8&tab=Overview,6,6,0,1.0
EBO Artificial Intelligence Virtual Agents,https://azuremarketplace.microsoft.com/en-us/marketplace/apps/ebo.ebo_ai?exp=ubp8&tab=Overview,1,1,0,1.0
Sayint,https://azuremarketplace.microsoft.com/en-us/marketplace/apps/zen3infosolutions.saas001?exp=ubp8&tab=Overview,10,10,0,1.0
Text Analytics & Sentiment Analysis API,https://azuremarketplace.microsoft.com/en-us/marketplace/apps/proxmedia.text2data_api?exp=ubp8&tab=Overview,1,1,0,1.0
Keboola Risk Innovation Workbench,https://azuremarketplace.microsoft.com/en-us/marketplace/apps/keboola_llc.keboola_risk_workbench?exp=ubp8&tab=Overview,87,90,3,1.0
X0PA AI Academia,https://azuremarketplace.microsoft.com/en-us/marketplace/apps/x0paai.x0paai_grad-hiring?exp=ubp8&tab=Overview,31,31,0,1.0
Ai-DBA,https://azuremarketplace.microsoft.com/en-us/marketplace/apps/fardsolutions.ai-dba?exp=ubp8&tab=Overview,1,1,0,1.0
Nulia Works – Unlock the value of Microsoft 365,https://azuremarketplace.microsoft.com/en-us/marketplace/apps/nulia.nulia-offer-1?exp=ubp8&tab=Overview,2,2,0,1.0
Samba.ai,https://azuremarketplace.microsoft.com/en-us/marketplace/apps/diffsolutionssro.samba?exp=ubp8&tab=Overview,4,4,0,1.0
METIS - Maritime Digital Transformation Solution,https://azuremarketplace.microsoft.com/en-us/marketplace/apps/metis.metis_id?exp=ubp8&tab=Overview,1,1,0,1.0
Aptivio Opportunity Signal Mining for Microsoft,https://azuremarketplace.microsoft.com/en-us/marketplace/apps/aptivio.aptivio-market-monitor-for-sales?exp=ubp8&tab=Overview,1,1,0,1.0
Navisphere® Vision,https://azuremarketplace.microsoft.com/en-us/marketplace/apps/chrobinsonworldwide.navispherevision?exp=ubp8&tab=Overview,2,2,0,1.0
Workativ Assistant,https://azuremarketplace.microsoft.com/en-us/marketplace/apps/workativ.workativ_assistant?exp=ubp8&tab=Overview,2,2,0,1.0
Observe.AI Voice Intelligence,https://azuremarketplace.microsoft.com/en-us/marketplace/apps/observerazorsharp.observeai-voice_ai_platform_for_call_centers?exp=ubp8&tab=Overview,192,197,5,1.0
Singula® Subscriber Intelligence,https://azuremarketplace.microsoft.com/en-us/marketplace/apps/paywizard.singula-1?exp=ubp8&tab=Overview,1,1,0,1.0
AssistEdge RPA,https://azuremarketplace.microsoft.com/en-us/marketplace/apps/edgevervesystemsltd.assistedge_rpa?exp=ubp8&tab=Overview,12,12,0,1.0
CloudPronouncer,https://azuremarketplace.microsoft.com/en-us/marketplace/apps/devissoftware.cloudpronouncer?exp=ubp8&tab=Overview,1,1,0,1.0
VeriPark Next Best Action,https://azuremarketplace.microsoft.com/en-us/marketplace/apps/veripark_solutions.veripark_nba?exp=ubp8&tab=Overview,5,5,0,1.0
Digital Elevation Model API - Terrainizer,https://azuremarketplace.microsoft.com/en-us/marketplace/apps/devissoftware.terrainizer?exp=ubp8&tab=Overview,1,1,0,1.0
HoloBuilder,https://azuremarketplace.microsoft.com/en-us/marketplace/apps/holobuilder.holobuilder?exp=ubp8&tab=Overview,13,13,0,1.0
TIBCO Data Science,https://azuremarketplace.microsoft.com/en-us/marketplace/apps/tibco-software.tibco-datascience?exp=ubp8&tab=Overview,40,40,0,1.0
BI.Qube,https://azuremarketplace.microsoft.com/en-us/marketplace/apps/llcitpro.biqube?exp=ubp8&tab=Overview,1,1,0,1.0
Playment,https://azuremarketplace.microsoft.com/en-us/marketplace/apps/playment.playment_fms?exp=ubp8&tab=Overview,11,11,0,1.0
Smart Customer Mobile (SCM®),https://azuremarketplace.microsoft.com/en-us/marketplace/apps/smartenergywater.smartenergywater?exp=ubp8&tab=Overview,1,1,0,1.0
Feedyou Platform,https://azuremarketplace.microsoft.com/en-us/marketplace/apps/feedyou.feedyou?exp=ubp8&tab=Overview,2,2,0,1.0
Datos,https://azuremarketplace.microsoft.com/en-us/marketplace/apps/datos-health.datos?exp=ubp8&tab=Overview,2,2,0,1.0
Examus proctoring service,https://azuremarketplace.microsoft.com/en-us/marketplace/apps/examus.examusproctoring?exp=ubp8&tab=Overview,3,3,0,1.0
Smart Mobile Workforce (SMW®),https://azuremarketplace.microsoft.com/en-us/marketplace/apps/smartenergywater.smartenergywater1?exp=ubp8&tab=Overview,1,1,0,1.0
Whichit,https://azuremarketplace.microsoft.com/en-us/marketplace/apps/whichitukltd.whichit?exp=ubp8&tab=Overview,1,1,0,1.0
Cognni Information Intelligence for M365,https://azuremarketplace.microsoft.com/en-us/marketplace/apps/shieldox.appsource_freetrial?exp=ubp8&tab=Overview,3,3,0,1.0
Turing Virtual Assistant (BOT),https://azuremarketplace.microsoft.com/en-us/marketplace/apps/turingchallenge.turingbot?exp=ubp8&tab=Overview,1,1,0,1.0
BigPanda AIOps,https://azuremarketplace.microsoft.com/en-us/marketplace/apps/bigpandainc.bigpanda?exp=ubp8&tab=Overview,117,117,0,1.0
ToolsGroup Multi-Echelon Inventory Optimization,https://azuremarketplace.microsoft.com/en-us/marketplace/apps/toolsgroup.tgmeiodemo?exp=ubp8&tab=Overview,1,1,0,1.0
Stratifyd,https://azuremarketplace.microsoft.com/en-us/marketplace/apps/stratifyd.stratifyd?exp=ubp8&tab=Overview,20,20,0,1.0
StatusToday,https://azuremarketplace.microsoft.com/en-us/marketplace/apps/statustoday.employee-analytics?exp=ubp8&tab=Overview,3,3,0,1.0
Records365,https://azuremarketplace.microsoft.com/en-us/marketplace/apps/recordpoint.r365init?exp=ubp8&tab=Overview,1,1,0,1.0
PrecisionLender,https://azuremarketplace.microsoft.com/en-us/marketplace/apps/precisionlender.precisionlender_pricingandprofitabilitysolution?exp=ubp8&tab=Overview,2,2,0,1.0
PrecisionLender,https://azuremarketplace.microsoft.com/en-us/marketplace/apps/precisionlender.precisionlender_pricingandprofitabilitysolution?exp=ubp8&tab=Overview,2,2,0,1.0
Sensin,https://azuremarketplace.microsoft.com/en-us/marketplace/apps/nextonia-4898698.sensin?exp=ubp8&tab=Overview,1,1,0,1.0
MindBridge Ai Auditor,https://azuremarketplace.microsoft.com/en-us/marketplace/apps/mind-bridge.mindbridge?exp=ubp8&tab=Overview,15,15,0,1.0
SHELFIE,https://azuremarketplace.microsoft.com/en-us/marketplace/apps/lakeba.shelfie?exp=ubp8&tab=Overview,1,1,0,1.0
Video Hyper-Personalization & Search Solution,https://azuremarketplace.microsoft.com/en-us/marketplace/apps/linius_technologies.linius_saas?exp=ubp8&tab=Overview,1,1,0,1.0
Pytorch on Ubuntu20.04LTS,https://azuremarketplace.microsoft.com/en-us/marketplace/apps/apps-4-rent.pytorch-on-ubuntu20?exp=ubp8&tab=Overview,5,5,0,1.0
Dictalogic AI-Powered Cloud Dictation,https://azuremarketplace.microsoft.com/en-us/marketplace/apps/dictalogic-5116849.dictalogic-ai?exp=ubp8&tab=Overview,1,1,0,1.0
CGI ProperPay,https://azuremarketplace.microsoft.com/en-us/marketplace/apps/cgi.d9827e75-9119-45ef-a505-67deec14db48?exp=ubp8&tab=Overview,3,3,0,1.0
Microsoft Professional Program(Open edX on Azure),https://azuremarketplace.microsoft.com/en-us/marketplace/apps/squarenet.mpp?exp=ubp8&tab=Overview,1,1,0,1.0
Epsillion: Document Automation in Word and Excel,https://azuremarketplace.microsoft.com/en-us/marketplace/apps/epsillionsoftwarelimited.epsillion2019?exp=ubp8&tab=Overview,1,1,0,1.0
Chattigo,https://azuremarketplace.microsoft.com/en-us/marketplace/apps/chattigospa-5040248.chattigo?exp=ubp8&tab=Overview,1,1,0,1.0
BEYE Banking Executive Dashboard Solution,https://azuremarketplace.microsoft.com/en-us/marketplace/apps/beye-ltd-5128948.beye-executive-management-dashboards-?exp=ubp8&tab=Overview,1,1,0,1.0
Alphalyr Unified Sales Management Platform,https://azuremarketplace.microsoft.com/en-us/marketplace/apps/alphalyr.agile-management-system?exp=ubp8&tab=Overview,1,1,0,1.0
Admissions Optimizer,https://azuremarketplace.microsoft.com/en-us/marketplace/apps/analytikus.leadscoringanalytikus?exp=ubp8&tab=Overview,1,1,0,1.0
ecoBuilding,https://azuremarketplace.microsoft.com/en-us/marketplace/apps/priva.priva-eco?exp=ubp8&tab=Overview,1,1,0,1.0
11Ants,https://azuremarketplace.microsoft.com/en-us/marketplace/apps/11antsanalytics.11antsric_overall?exp=ubp8&tab=Overview,2,2,0,1.0
Aware Employee Insights & Analytics,https://azuremarketplace.microsoft.com/en-us/marketplace/apps/wiretap.aware_monitoring?exp=ubp8&tab=Overview,1,1,0,1.0
Voximal Stack,https://azuremarketplace.microsoft.com/en-us/marketplace/apps/ulex.voximal?exp=ubp8&tab=Overview,2,2,0,1.0
H2O Driverless AI,https://azuremarketplace.microsoft.com/en-us/marketplace/apps/h2o-ai.h2o-driverles-ai?exp=ubp8&tab=Overview,2,2,0,1.0
Blue Prism Intelligent Automation,https://azuremarketplace.microsoft.com/en-us/marketplace/apps/blueprismlimited-4827145.blueprismweb?exp=ubp8&tab=Overview,1,1,0,1.0
Algorithmia Enterprise,https://azuremarketplace.microsoft.com/en-us/marketplace/apps/algorithmia.algorithmiaenterprise?exp=ubp8&tab=Overview,14,14,0,1.0
Pobuca Experience Cloud,https://azuremarketplace.microsoft.com/en-us/marketplace/apps/pobuca.pobuca_customer_voice_transactable?exp=ubp8&tab=Overview,1,1,0,1.0
Integrated Audience Analysis,https://azuremarketplace.microsoft.com/en-us/marketplace/apps/affinio.affinio?exp=ubp8&tab=Overview,47,47,0,1.0
Trūata Calibrate - Automated Privacy Risk Assessments,https://azuremarketplace.microsoft.com/en-us/marketplace/apps/truata1612259728221.calibrate?exp=ubp8&tab=Overview,4,4,0,1.0
Symend,https://azuremarketplace.microsoft.com/en-us/marketplace/apps/symendinc.symend_transactable_1?exp=ubp8&tab=Overview,1,1,0,1.0
Symend,https://azuremarketplace.microsoft.com/en-us/marketplace/apps/symendinc.symend_transactable_1?exp=ubp8&tab=Overview,1,1,0,1.0
SmartWithFood,https://azuremarketplace.microsoft.com/en-us/marketplace/apps/smartwithfood.smartwithfood?exp=ubp8&tab=Overview,2,2,0,1.0
Appsurify TestBrain,https://azuremarketplace.microsoft.com/en-us/marketplace/apps/appsurifyinc1606933045773.appsurify3001?exp=ubp8&tab=Overview,3,3,0,1.0
Pachyderm,https://azuremarketplace.microsoft.com/en-us/marketplace/apps/pachyderminc1585170006545.pachyderm-enterprise-license?exp=ubp8&tab=Overview,13,13,0,1.0
Keboola Digital Sandbox,https://azuremarketplace.microsoft.com/en-us/marketplace/apps/keboola_llc.keboola_digital_sandbox?exp=ubp8&tab=Overview,87,90,3,1.0
DataVisor Enterprise ML for Fraud and AML,https://azuremarketplace.microsoft.com/en-us/marketplace/apps/datavisor.datavisor_dvector_uml?exp=ubp8&tab=Overview,1,1,0,1.0
Informatica Enterprise Data Preparation,https://azuremarketplace.microsoft.com/en-us/marketplace/apps/informatica.informaica-edp-1041?exp=ubp8&tab=Overview,10,10,0,1.0
Geotrend Market Intelligence,https://azuremarketplace.microsoft.com/en-us/marketplace/apps/geotrend1595274423582.geotrend_market_intelligence?exp=ubp8&tab=Overview,1,1,0,1.0
Kyligence Cloud,https://azuremarketplace.microsoft.com/en-us/marketplace/apps/kyligence.kyligence-cloud-saas?exp=ubp8&tab=Overview,2,2,0,1.0
Couchbase Server and Sync Gateway,https://azuremarketplace.microsoft.com/en-us/marketplace/apps/couchbase.couchbase-enterprise?exp=ubp8&tab=Overview,86,90,4,1.0
Verint Workforce Optimization,https://azuremarketplace.microsoft.com/en-us/marketplace/apps/groupelitecommunicationsinc1620843022650.verint_workforce_optimization?exp=ubp8&tab=Overview,1,1,0,1.0
Classify360,https://azuremarketplace.microsoft.com/en-us/marketplace/apps/congruity360.classify360?exp=ubp8&tab=Overview,2,2,0,1.0
Classify360,https://azuremarketplace.microsoft.com/en-us/marketplace/apps/congruity360.classify360?exp=ubp8&tab=Overview,2,2,0,1.0
MAKANA Python Function,https://azuremarketplace.microsoft.com/en-us/marketplace/apps/mobius_logic-1291876.makana-python-function?exp=ubp8&tab=Overview,1,1,0,1.0
AtScale,https://azuremarketplace.microsoft.com/en-us/marketplace/apps/atscaleinc.atscale?exp=ubp8&tab=Overview,4,4,0,1.0
Grafana - secured and supported by Hossted,https://azuremarketplace.microsoft.com/en-us/marketplace/apps/meanio.linnovate-grafana?exp=ubp8&tab=Overview,1,1,0,1.0
Redash - secured and supported by Hossted,https://azuremarketplace.microsoft.com/en-us/marketplace/apps/meanio.redash?exp=ubp8&tab=Overview,2,2,0,1.0
OpenideaL - secured and supported by Hossted,https://azuremarketplace.microsoft.com/en-us/marketplace/apps/meanio.openideal3?exp=ubp8&tab=Overview,1,1,0,1.0
ZyLAB ONE,https://azuremarketplace.microsoft.com/en-us/marketplace/apps/zylab.ediscovery-solution?exp=ubp8&tab=Overview,23,23,0,1.0
Shufti Pro Identity verification KYC AML solutions,https://azuremarketplace.microsoft.com/en-us/marketplace/apps/shuftiprolimited1602758381994.shuftipro_kyc_service?exp=ubp8&tab=Overview,1,1,0,1.0
KLoBot,https://azuremarketplace.microsoft.com/en-us/marketplace/apps/klsoftwaretechnologiesinc1597074413802.ai-chatbot?exp=ubp8&tab=Overview,2,2,0,1.0
KnowledgeLake Platform,https://azuremarketplace.microsoft.com/en-us/marketplace/apps/knowledge-lake.kl_platform?exp=ubp8&tab=Overview,2,2,0,1.0
Aqtiva,https://azuremarketplace.microsoft.com/en-us/marketplace/apps/maticapartners.aqtiva_quality?exp=ubp8&tab=Overview,20,20,0,1.0
UbiOps,https://azuremarketplace.microsoft.com/en-us/marketplace/apps/dutchanalytics1598648686086.ubiops?exp=ubp8&tab=Overview,5,5,0,1.0
AI.SEE,https://azuremarketplace.microsoft.com/en-us/marketplace/apps/elunicag1598277660863.aisee?exp=ubp8&tab=Overview,1,1,0,1.0
DataWeave Brand Analytics,https://azuremarketplace.microsoft.com/en-us/marketplace/apps/infoweaveanalyticsprivatelimited1586947967858.dataweave-brand-analytics?exp=ubp8&tab=Overview,78,78,0,1.0
arabot chatbot for Enterprise,https://azuremarketplace.microsoft.com/en-us/marketplace/apps/arabotcompanyltd1595335641194.arabot_1?exp=ubp8&tab=Overview,1,1,0,1.0
Tiliter Recognition API,https://azuremarketplace.microsoft.com/en-us/marketplace/apps/tiliterptyltd1593496244090.tiliter?exp=ubp8&tab=Overview,1,1,0,1.0
Context To Call,https://azuremarketplace.microsoft.com/en-us/marketplace/apps/vgroupconsultancyservicesprivatelimited.vgroup_digital?exp=ubp8&tab=Overview,1,1,0,1.0
Hopsworks for Azure,https://azuremarketplace.microsoft.com/en-us/marketplace/apps/logicalclocks1604934742370.hopsworks_azure?exp=ubp8&tab=Overview,2,2,0,1.0
EXASOL Analytics Database (BYOL),https://azuremarketplace.microsoft.com/en-us/marketplace/apps/exasol.exasol-analytics-database-byol?exp=ubp8&tab=Overview,16,16,0,1.0
Panorama Necto - Business Intelligence,https://azuremarketplace.microsoft.com/en-us/marketplace/apps/panorama-necto.panorama-necto-business-intelligence?exp=ubp8&tab=Overview,18,18,0,1.0
Syncfusion Dashboard Server,https://azuremarketplace.microsoft.com/en-us/marketplace/apps/syncfusion.dashboard-server-vm?exp=ubp8&tab=Overview,1,1,0,1.0
Bluefish Editor on Windows Server 2016,https://azuremarketplace.microsoft.com/en-us/marketplace/apps/apps-4-rent.bluefish-editor-windows-server-2016?exp=ubp8&tab=Overview,3,3,0,1.0
CALUMO Corporate Performance Management,https://azuremarketplace.microsoft.com/en-us/marketplace/apps/calumolabsptyltd.calumo-cpm?exp=ubp8&tab=Overview,1,1,0,1.0
Axonize IoT Orchestration Platform,https://azuremarketplace.microsoft.com/en-us/marketplace/apps/axonize.axonize?exp=ubp8&tab=Overview,3,3,0,1.0
Apta-HR,https://azuremarketplace.microsoft.com/en-us/marketplace/apps/aptagrimconsultingllp1644987858185.apta-hr?exp=ubp8&tab=Overview,3,3,0,1.0
Vaultedge Mortgage Automation,https://azuremarketplace.microsoft.com/en-us/marketplace/apps/thinklabsdbavaultedgesoftware1620841709223.vaultedge_mortgage_automation_saas?exp=ubp8&tab=Overview,3,3,0,1.0
TCS Intelligent Power Plant™,https://azuremarketplace.microsoft.com/en-us/marketplace/apps/tataconsultancyservices-iot.tcs_ip2_saas?exp=ubp8&tab=Overview,1,1,0,1.0
OneView,https://azuremarketplace.microsoft.com/en-us/marketplace/apps/onenebulaptyltd-1973161.oneview?exp=ubp8&tab=Overview,2,2,0,1.0
EHSQ Management System,https://azuremarketplace.microsoft.com/en-us/marketplace/apps/intelextechnologiesinc.ehsq?exp=ubp8&tab=Overview,18,18,0,1.0
Aladdin - Asset Lifecycle Management Software,https://azuremarketplace.microsoft.com/en-us/marketplace/apps/sge-power-fze.aladdin?exp=ubp8&tab=Overview,4,4,0,1.0
Plexure Retail Personalization,https://azuremarketplace.microsoft.com/en-us/marketplace/apps/plexure.c82dc2fc-817b-487e-ae83-1658c1bc8ff2?exp=ubp8&tab=Overview,1,1,0,1.0
TAMI,https://azuremarketplace.microsoft.com/en-us/marketplace/apps/salesoptimize.salesoptimize?exp=ubp8&tab=Overview,138,139,1,1.0
Roivenue,https://azuremarketplace.microsoft.com/en-us/marketplace/apps/roivenue.4709304?exp=ubp8&tab=Overview,3,3,0,1.0
MTWO Cloud,https://azuremarketplace.microsoft.com/en-us/marketplace/apps/ribsoftware.mtwocloud?exp=ubp8&tab=Overview,3,3,0,1.0
Prodsmart,https://azuremarketplace.microsoft.com/en-us/marketplace/apps/prodsmart.com_prodsmart_01?exp=ubp8&tab=Overview,16,16,0,1.0
Perspective – Data Governor,https://azuremarketplace.microsoft.com/en-us/marketplace/apps/perspective.6c5fcd8a-a191-43c9-a7a6-a55b686f6c71?exp=ubp8&tab=Overview,3,3,0,1.0
Metadata Management Automation and Data Lineage,https://azuremarketplace.microsoft.com/en-us/marketplace/apps/octopai.metadata-discovery-and-management-automation?exp=ubp8&tab=Overview,1,1,0,1.0
9 Spokes Smart Business Dashboard,https://azuremarketplace.microsoft.com/en-us/marketplace/apps/9spokesinternationallimited.9spokes_smbdashboard_appsource?exp=ubp8&tab=Overview,12,12,0,1.0
"Demand Forecasting, Prescriptive Inventory Management",https://azuremarketplace.microsoft.com/en-us/marketplace/apps/obase.obs-dtlr-rep-01?exp=ubp8&tab=Overview,1,1,0,1.0
Social Intranet Analytics -for SharePoint and others,https://azuremarketplace.microsoft.com/en-us/marketplace/apps/mindlabsolutions.social-intranet-analytics-netmind-core?exp=ubp8&tab=Overview,2,2,0,1.0
Finviews Listed Company Fundamentals,https://azuremarketplace.microsoft.com/en-us/marketplace/apps/managility.finviews?exp=ubp8&tab=Overview,1,1,0,1.0
Logistrics Services,https://azuremarketplace.microsoft.com/en-us/marketplace/apps/logistrics.logistrics_services?exp=ubp8&tab=Overview,1,1,0,1.0
Limelight Software,https://azuremarketplace.microsoft.com/en-us/marketplace/apps/limelight.budgeting-forecasting-reporting-app?exp=ubp8&tab=Overview,14,14,0,1.0
MDClone Healthcare Data Sandbox,https://azuremarketplace.microsoft.com/en-us/marketplace/apps/mdclone.mdclone1?exp=ubp8&tab=Overview,2,2,0,1.0
MoData -Sales Analytics For Microsoft Dynamics,https://azuremarketplace.microsoft.com/en-us/marketplace/apps/modata.modata?exp=ubp8&tab=Overview,1,1,0,1.0
Captivate Chat,https://azuremarketplace.microsoft.com/en-us/marketplace/apps/captivateioltd1603115128507.captivatehub?exp=ubp8&tab=Overview,4,4,0,1.0
Incident Management System,https://azuremarketplace.microsoft.com/en-us/marketplace/apps/intelextechnologiesinc.incidentmanagement?exp=ubp8&tab=Overview,2,2,0,1.0
The Hark Platform,https://azuremarketplace.microsoft.com/en-us/marketplace/apps/hark.hark-platform-energy-management?exp=ubp8&tab=Overview,2,2,0,1.0
exTables,https://azuremarketplace.microsoft.com/en-us/marketplace/apps/expectus.extables?exp=ubp8&tab=Overview,1,1,0,1.0
FirstHive,https://azuremarketplace.microsoft.com/en-us/marketplace/apps/emart-solutions-india-pvt-ltd.firsthive?exp=ubp8&tab=Overview,12,12,0,1.0
FirstHive,https://azuremarketplace.microsoft.com/en-us/marketplace/apps/emart-solutions-india-pvt-ltd.firsthive?exp=ubp8&tab=Overview,12,12,0,1.0
Edsby,https://azuremarketplace.microsoft.com/en-us/marketplace/apps/edsby.edsby?exp=ubp8&tab=Overview,71,73,2,1.0
Edsby Analytics,https://azuremarketplace.microsoft.com/en-us/marketplace/apps/edsbycanada-4680407.edsbyanalytics?exp=ubp8&tab=Overview,71,73,2,1.0
SharePoint Vitals,https://azuremarketplace.microsoft.com/en-us/marketplace/apps/gtconsult-3395443.vitals?exp=ubp8&tab=Overview,1,1,0,1.0
Balanced Scorecard Software with Power BI,https://azuremarketplace.microsoft.com/en-us/marketplace/apps/corporater.balanced-scorecard_with_powerbi?exp=ubp8&tab=Overview,1,1,0,1.0
Cloudamize,https://azuremarketplace.microsoft.com/en-us/marketplace/apps/cloudamize.cloudamize?exp=ubp8&tab=Overview,1,1,0,1.0
Chartio,https://azuremarketplace.microsoft.com/en-us/marketplace/apps/chartio-5300664.chartio?exp=ubp8&tab=Overview,244,244,0,1.0
Folksonomy Advance Data Analytics,https://azuremarketplace.microsoft.com/en-us/marketplace/apps/bismart.bismart_folksonomy?exp=ubp8&tab=Overview,5,5,0,1.0
iMonitor,https://azuremarketplace.microsoft.com/en-us/marketplace/apps/broadsmart.imonitor?exp=ubp8&tab=Overview,1,1,0,1.0
Smart Buildings by ICONICS,https://azuremarketplace.microsoft.com/en-us/marketplace/apps/iconics.energy_smart_buildings?exp=ubp8&tab=Overview,1,1,0,1.0
Anybrain Security Platform for gaming & esports,https://azuremarketplace.microsoft.com/en-us/marketplace/apps/anybrainsa1599752030610.anybrain_security_platform?exp=ubp8&tab=Overview,1,1,0,1.0
FCP ML DevOps Service (Size S),https://azuremarketplace.microsoft.com/en-us/marketplace/apps/hms-analytical-software-gmbh-571796.hms_azure_app_service4fcp_size_s?exp=ubp8&tab=Overview,1,1,0,1.0
tiLly {today i Learned} Microsoft Teams BOT,https://azuremarketplace.microsoft.com/en-us/marketplace/apps/tillygrouplimited1635070909209.tilly?exp=ubp8&tab=Overview,2,2,0,1.0
\\ Forecast Supply Chain with Machine Learning,https://azuremarketplace.microsoft.com/en-us/marketplace/apps/syone1617042241635.supply_chain_ml?exp=ubp8&tab=Overview,2,2,0,1.0
wAnywhere,https://azuremarketplace.microsoft.com/en-us/marketplace/apps/shephertztechnologies1585804665473.wanywhere?exp=ubp8&tab=Overview,1,1,0,1.0
Katonic Data Science & MLOps Platform,https://azuremarketplace.microsoft.com/en-us/marketplace/apps/katonicptyltd1613444956037.katonicmlops?exp=ubp8&tab=Overview,1,1,0,1.0
Landis Contact Center,https://azuremarketplace.microsoft.com/en-us/marketplace/apps/landis-technologies.o365cctrial?exp=ubp8&tab=Overview,2,2,0,1.0
Insurity Software Solutions,https://azuremarketplace.microsoft.com/en-us/marketplace/apps/insurity.insurance_systems?exp=ubp8&tab=Overview,2,2,0,1.0
ClickCompliance,https://azuremarketplace.microsoft.com/en-us/marketplace/apps/clickcompliance.clickcompliance?exp=ubp8&tab=Overview,7,7,0,1.0
mHub Cloud,https://azuremarketplace.microsoft.com/en-us/marketplace/apps/crossmasters.mhubc?exp=ubp8&tab=Overview,3,3,0,1.0
Odoo on Ubuntu 18.04,https://azuremarketplace.microsoft.com/en-us/marketplace/apps/apps-4-rent.odoo-on-ubuntu?exp=ubp8&tab=Overview,2,2,0,1.0
DokuWiki on Windows 2019 ,https://azuremarketplace.microsoft.com/en-us/marketplace/apps/apps-4-rent.docuwiki-on-windows-2019?exp=ubp8&tab=Overview,1,1,0,1.0
sales-i,https://azuremarketplace.microsoft.com/en-us/marketplace/apps/sales-i.sales-i?exp=ubp8&tab=Overview,135,135,0,1.0
SigParser,https://azuremarketplace.microsoft.com/en-us/marketplace/apps/sigparser.sigparser_saas?exp=ubp8&tab=Overview,2,2,0,1.0
Invisible Read Receipts & Click Tracking for Email,https://azuremarketplace.microsoft.com/en-us/marketplace/apps/blackpearlmail1580490531513.blackpearlmail-insights?exp=ubp8&tab=Overview,1,1,0,1.0
Xero Custom Connector by FreshBI,https://azuremarketplace.microsoft.com/en-us/marketplace/apps/freshbi.xero?exp=ubp8&tab=Overview,4,4,0,1.0
COPLINK X,https://azuremarketplace.microsoft.com/en-us/marketplace/apps/forensiclogic-2755350.coplink_x?exp=ubp8&tab=Overview,2,2,0,1.0
ClearBlade IoT Edge Platform,https://azuremarketplace.microsoft.com/en-us/marketplace/apps/clearblade.clearblade-edge-platform?exp=ubp8&tab=Overview,1,1,0,1.0
Seidor BannaAnalytics,https://azuremarketplace.microsoft.com/en-us/marketplace/apps/seidor.v01?exp=ubp8&tab=Overview,4,4,0,1.0
Run:ai Atlas Platform,https://azuremarketplace.microsoft.com/en-us/marketplace/apps/runailabsltd1647779544073.runai_atlas_v1?exp=ubp8&tab=Overview,1,1,0,1.0
Istech Azure Managed Services,https://azuremarketplace.microsoft.com/en-us/marketplace/apps/datamarketbilgihizmetlerias.istechazure?exp=ubp8&tab=Overview,1,1,0,1.0
Platform Security - Managed Service,https://azuremarketplace.microsoft.com/en-us/marketplace/apps/newsignature.platform_security?exp=ubp8&tab=Overview,80,80,0,1.0
HYAS Insight,https://azuremarketplace.microsoft.com/en-us/marketplace/apps/hyas.insight?exp=ubp8&tab=Overview,1,1,0,1.0
ZoomCharts Drill Down PRO Visuals for Power BI,https://azuremarketplace.microsoft.com/en-us/marketplace/apps/32204330.zoomcharts-saas-licensing?exp=ubp8&tab=Overview,41,42,1,1.0
Micromail Managed Services,https://azuremarketplace.microsoft.com/en-us/marketplace/apps/micromail.micromailmanagedservices?exp=ubp8&tab=Overview,1,1,0,1.0
Altia's Covert Operations Solution,https://azuremarketplace.microsoft.com/en-us/marketplace/apps/altiasolutionsltd1604050610462.altia-abm-pegasus?exp=ubp8&tab=Overview,1,1,0,1.0
Keboola Connection,https://azuremarketplace.microsoft.com/en-us/marketplace/apps/keboolaczechsro1605129526744.test?exp=ubp8&tab=Overview,87,90,3,1.0
Avanade Isotope Managed Service,https://azuremarketplace.microsoft.com/en-us/marketplace/apps/avanade-5299580.amp_isotope_access?exp=ubp8&tab=Overview,1,1,0,1.0
ChillETL Framework,https://azuremarketplace.microsoft.com/en-us/marketplace/apps/clouddatasolutionsllc1598917148109.chilletl01?exp=ubp8&tab=Overview,3,3,0,1.0
cta.x - Control Test Automation,https://azuremarketplace.microsoft.com/en-us/marketplace/apps/grantthorntonllp1588703404475.cta_saas?exp=ubp8&tab=Overview,1,1,0,1.0
GABO Warehouse Framework,https://azuremarketplace.microsoft.com/en-us/marketplace/apps/gabombhcokg1585743032702.gabo_warehouse_framework?exp=ubp8&tab=Overview,1,1,0,1.0
Financial Reporting Dashboard,https://azuremarketplace.microsoft.com/en-us/marketplace/apps/solutionbi1613123678096.financial_reporting_app?exp=ubp8&tab=Overview,1,1,0,1.0
OpenBlue Central Utility Plant,https://azuremarketplace.microsoft.com/en-us/marketplace/apps/johnsoncontrols.openblue-cup?exp=ubp8&tab=Overview,1,1,0,1.0
TIBCO WebFOCUS,https://azuremarketplace.microsoft.com/en-us/marketplace/apps/tibco-software.tibco_webfocus?exp=ubp8&tab=Overview,154,154,0,1.0
Teradata Viewpoint (DIY),https://azuremarketplace.microsoft.com/en-us/marketplace/apps/teradata.vantage-teradata-viewpoint?exp=ubp8&tab=Overview,22,22,0,1.0
Teradata Data Mover (DIY),https://azuremarketplace.microsoft.com/en-us/marketplace/apps/teradata.vantage-teradata-data-mover?exp=ubp8&tab=Overview,3,3,0,1.0
Protegrity Data Protection Platform,https://azuremarketplace.microsoft.com/en-us/marketplace/apps/protegrityusainc1627404648458.pub_saas_billboard_v1?exp=ubp8&tab=Overview,14,14,0,1.0
"Teradata Viewpoint (DIY, IntelliSphere)",https://azuremarketplace.microsoft.com/en-us/marketplace/apps/teradata.vantage-teradata-viewpoint-intellisphere?exp=ubp8&tab=Overview,22,22,0,1.0
Hadoop-v-3.3.1,https://azuremarketplace.microsoft.com/en-us/marketplace/apps/nilespartnersinc1617691698386.hadoop_v-3-3-1?exp=ubp8&tab=Overview,1,1,0,1.0
Minitab Workspace,https://azuremarketplace.microsoft.com/en-us/marketplace/apps/minitabllc1614270009582.workspace?exp=ubp8&tab=Overview,82,82,0,1.0
调研工厂,https://azuremarketplace.microsoft.com/en-us/marketplace/apps/1624523448084.surveywork?exp=ubp8&tab=Overview,2,2,0,1.0
PrecisionLender,https://azuremarketplace.microsoft.com/en-us/marketplace/apps/q2ebanking1620139003979.precisionlender?exp=ubp8&tab=Overview,2,2,0,1.0
PrecisionLender,https://azuremarketplace.microsoft.com/en-us/marketplace/apps/q2ebanking1620139003979.precisionlender?exp=ubp8&tab=Overview,2,2,0,1.0
SwiftERM,https://azuremarketplace.microsoft.com/en-us/marketplace/apps/swifterm1586974095708.swifterm?exp=ubp8&tab=Overview,1,1,0,1.0
Aspen Enterprise IP.21 Historian™,https://azuremarketplace.microsoft.com/en-us/marketplace/apps/aspentechnologyhq-1353108.aspen_mes_collaborative?exp=ubp8&tab=Overview,21,21,0,1.0
Time is Ltd. Analytics,https://azuremarketplace.microsoft.com/en-us/marketplace/apps/timeisltd.til_analytics?exp=ubp8&tab=Overview,1,1,0,1.0
ECOLAB3D Digital Platform,https://azuremarketplace.microsoft.com/en-us/marketplace/apps/ecolab1586233219626.ecolab3d?exp=ubp8&tab=Overview,1,1,0,1.0
Phoenix,https://azuremarketplace.microsoft.com/en-us/marketplace/apps/gemsgroupholdingslimited1606120362322.tmrw001?exp=ubp8&tab=Overview,1,1,0,1.0
Denodo Platform 8.0 (BYOL),https://azuremarketplace.microsoft.com/en-us/marketplace/apps/denodo.denodo-platform-8_0-vm-byol?exp=ubp8&tab=Overview,34,35,1,1.0
iServer,https://azuremarketplace.microsoft.com/en-us/marketplace/apps/orbussoftware.iserver-2020?exp=ubp8&tab=Overview,17,17,0,1.0
Alloc8 - Workforce Management & Scheduling,https://azuremarketplace.microsoft.com/en-us/marketplace/apps/alloc8holdingsptyltd1603855891477.alloc8?exp=ubp8&tab=Overview,1,1,0,1.0
eCubeApps Free online forms,https://azuremarketplace.microsoft.com/en-us/marketplace/apps/ispatialtechnosolutions1590954335966.ecubeapps?exp=ubp8&tab=Overview,2,2,0,1.0
Informatica Axon Data Governance,https://azuremarketplace.microsoft.com/en-us/marketplace/apps/informatica.informatica-axon-70?exp=ubp8&tab=Overview,8,8,0,1.0
INDEXIMA Analytics Engine,https://azuremarketplace.microsoft.com/en-us/marketplace/apps/indexima1594300233028.indexima-arm-1?exp=ubp8&tab=Overview,1,1,0,1.0
Covid19 App,https://azuremarketplace.microsoft.com/en-us/marketplace/apps/infotechpvtlimited-1015853.c19_hck?exp=ubp8&tab=Overview,1,1,0,1.0
E-mail Converter,https://azuremarketplace.microsoft.com/en-us/marketplace/apps/365softwarellp1590916794951.emailconverter?exp=ubp8&tab=Overview,1,1,0,1.0
InCyber TPIT - True prediction of insider threats,https://azuremarketplace.microsoft.com/en-us/marketplace/apps/incyber1594028336474.incyber-tpit-saas?exp=ubp8&tab=Overview,2,2,0,1.0
Informatica Data Engineering Streaming,https://azuremarketplace.microsoft.com/en-us/marketplace/apps/informatica.informaica-des-1041?exp=ubp8&tab=Overview,2,2,0,1.0
Servicios Manejados Sentinel,https://azuremarketplace.microsoft.com/en-us/marketplace/apps/nebulan1597762163871.nebulanzerotrust?exp=ubp8&tab=Overview,4,4,0,1.0
3drepo,https://azuremarketplace.microsoft.com/en-us/marketplace/apps/3drepo.3drepo?exp=ubp8&tab=Overview,1,1,0,1.0
Denodo Standard (Hourly),https://azuremarketplace.microsoft.com/en-us/marketplace/apps/denodo.denodo-8_0-std-vm-payg?exp=ubp8&tab=Overview,34,35,1,1.0
Denodo Enterprise (Annual),https://azuremarketplace.microsoft.com/en-us/marketplace/apps/denodo.denodo-8_0-ent-saas-annual?exp=ubp8&tab=Overview,34,35,1,1.0
Denodo Professional (Annual),https://azuremarketplace.microsoft.com/en-us/marketplace/apps/denodo.denodo-8_0-pro-saas-annual?exp=ubp8&tab=Overview,34,35,1,1.0
MonetDB server,https://azuremarketplace.microsoft.com/en-us/marketplace/apps/monetdbsolutions1611751313758.monetdb?exp=ubp8&tab=Overview,1,1,0,1.0
Cityworks Online,https://azuremarketplace.microsoft.com/en-us/marketplace/apps/trimbleinc1629207042907.cityworkstest1?exp=ubp8&tab=Overview,11,11,0,1.0
AVEVA™ Data Hub,https://azuremarketplace.microsoft.com/en-us/marketplace/apps/aveva1.aveva_data_hub?exp=ubp8&tab=Overview,1,1,0,1.0
Apty for Microsoft Dynamics,https://azuremarketplace.microsoft.com/en-us/marketplace/apps/apty.apty_dap_client?exp=ubp8&tab=Overview,125,129,4,1.0
Elasticsearch on Windows Server 2019,https://azuremarketplace.microsoft.com/en-us/marketplace/apps/apps-4-rent.elasticsearch-on-win2019?exp=ubp8&tab=Overview,2,2,0,1.0
Elasticsearch on Windows Server 2016,https://azuremarketplace.microsoft.com/en-us/marketplace/apps/apps-4-rent.elasticsearch-on-win2016?exp=ubp8&tab=Overview,1,1,0,1.0
Clootrack,https://azuremarketplace.microsoft.com/en-us/marketplace/apps/clootracksoftwarelabsprivatelimited1594709558779.ct_experience_analytics?exp=ubp8&tab=Overview,31,32,1,1.0
Aspen Petroleum Scheduler,https://azuremarketplace.microsoft.com/en-us/marketplace/apps/aspentechnologyhq-1353108.aspen_petroleum_scheduler?exp=ubp8&tab=Overview,6,6,0,1.0
Luminate Store Execution,https://azuremarketplace.microsoft.com/en-us/marketplace/apps/jdasoftware-global.luminate_store_execution_appsource?exp=ubp8&tab=Overview,2,2,0,1.0
Blue Yonder Transportation Management,https://azuremarketplace.microsoft.com/en-us/marketplace/apps/jdasoftware-global.jda_transportation_management_appsource?exp=ubp8&tab=Overview,2,2,0,1.0
HappySignals IT Experience Management Platform,https://azuremarketplace.microsoft.com/en-us/marketplace/apps/happysignalsoy1641991037072.happysignals_platform?exp=ubp8&tab=Overview,25,26,1,1.0
Vymo's Sales Engagement Platform for BFSI Frontline Teams,https://azuremarketplace.microsoft.com/en-us/marketplace/apps/vymo1641298019706.vymo_lms_123?exp=ubp8&tab=Overview,154,159,5,1.0
Syook Insite Azure Application,https://azuremarketplace.microsoft.com/en-us/marketplace/apps/sparkyotechnologyprivatelimited1581665803175.insite_azure?exp=ubp8&tab=Overview,2,2,0,1.0
EEC ControlUp as a Services,https://azuremarketplace.microsoft.com/en-us/marketplace/apps/eecservicesfzllc1604836615706.controluponazure001?exp=ubp8&tab=Overview,1,1,0,1.0
Health Catalyst Data Operating System,https://azuremarketplace.microsoft.com/en-us/marketplace/apps/healthcatalyst.dos-v1?exp=ubp8&tab=Overview,2,2,0,1.0
Scuba Analytics,https://azuremarketplace.microsoft.com/en-us/marketplace/apps/scubaanalytics.scuba_saas?exp=ubp8&tab=Overview,2,2,0,1.0
ICONICS Suite 10.97.1,https://azuremarketplace.microsoft.com/en-us/marketplace/apps/iconics.iconics-suite-10971?exp=ubp8&tab=Overview,1,1,0,1.0
Qlik Forts,https://azuremarketplace.microsoft.com/en-us/marketplace/apps/qlik.qlik_forts?exp=ubp8&tab=Overview,1,1,0,1.0
Indicators & Dimensions Definition Tool,https://azuremarketplace.microsoft.com/en-us/marketplace/apps/bismart.indicators_dimensions_definition_tool?exp=ubp8&tab=Overview,1,1,0,1.0
advaisor Outlook Add-in,https://azuremarketplace.microsoft.com/en-us/marketplace/apps/advaisor.advaisor_add-in?exp=ubp8&tab=Overview,1,1,0,1.0
Rumors Monitoring,https://azuremarketplace.microsoft.com/en-us/marketplace/apps/rumorsllc1588759807760.rumors-monitoring?exp=ubp8&tab=Overview,1,1,0,1.0
Privitar,https://azuremarketplace.microsoft.com/en-us/marketplace/apps/privitar.privitar_publisher?exp=ubp8&tab=Overview,1,1,0,1.0
Fivetran Connector for Dynamics 365,https://azuremarketplace.microsoft.com/en-us/marketplace/apps/fivetran.fivetran_dynamics365?exp=ubp8&tab=Overview,349,366,17,1.0
Plone CMS on Ubuntu 18.04,https://azuremarketplace.microsoft.com/en-us/marketplace/apps/apps-4-rent.plone-cms-on-ubuntu?exp=ubp8&tab=Overview,1,1,0,1.0
ArangoDB NoSQL Database on Ubuntu 1,https://azuremarketplace.microsoft.com/en-us/marketplace/apps/apps-4-rent.arangodb-on-ubuntu?exp=ubp8&tab=Overview,1,1,0,1.0
Denodo Data Virtualization,https://azuremarketplace.microsoft.com/en-us/marketplace/apps/denodo.denodo_data_virtualization?exp=ubp8&tab=Overview,34,35,1,1.0
Infosys Cloud Data Validation Solution,https://azuremarketplace.microsoft.com/en-us/marketplace/apps/infosys.infosys_cloud_data_validation_solution?exp=ubp8&tab=Overview,1,1,0,1.0
Rockwell Automation Industrial IoT platform,https://azuremarketplace.microsoft.com/en-us/marketplace/apps/rockwellautomationinc.rockwell_automation_factorytalk_innovationsuite?exp=ubp8&tab=Overview,3,3,0,1.0
Denodo Enterprise (Hourly),https://azuremarketplace.microsoft.com/en-us/marketplace/apps/denodo.denodo-8_0-ent-vm-payg?exp=ubp8&tab=Overview,34,35,1,1.0
Denodo Enterprise Plus (Hourly),https://azuremarketplace.microsoft.com/en-us/marketplace/apps/denodo.denodo-8_0-ent_plus-vm-payg?exp=ubp8&tab=Overview,34,35,1,1.0
Fotham Web Analytics on Ubuntu 18.04,https://azuremarketplace.microsoft.com/en-us/marketplace/apps/apps-4-rent.fathom-on-ubuntu?exp=ubp8&tab=Overview,1,1,0,1.0
FieldTracker.42 - BIM 4D Viewer,https://azuremarketplace.microsoft.com/en-us/marketplace/apps/cad42.fieldtracker_bim4d_viewer?exp=ubp8&tab=Overview,1,1,0,1.0
TeleTracking,https://azuremarketplace.microsoft.com/en-us/marketplace/apps/teletrackingtechnologies1581023862051.test-offer-1?exp=ubp8&tab=Overview,2,2,0,1.0
SurveyMonkey MS Teams,https://azuremarketplace.microsoft.com/en-us/marketplace/apps/surveymonkey.surveymonkey-ms-teams?exp=ubp8&tab=Overview,1000,1000,0,1.0
DeviceOn For Azure (Standard),https://azuremarketplace.microsoft.com/en-us/marketplace/apps/advantech.deviecon_on_windows_vm_v1?exp=ubp8&tab=Overview,6,6,0,1.0
iTwin Platform,https://azuremarketplace.microsoft.com/en-us/marketplace/apps/bentleysystemsincorporated-1164124.itwin?exp=ubp8&tab=Overview,1,1,0,1.0
Classify360,https://azuremarketplace.microsoft.com/en-us/marketplace/apps/congruity360.congruity360?exp=ubp8&tab=Overview,2,2,0,1.0
Classify360,https://azuremarketplace.microsoft.com/en-us/marketplace/apps/congruity360.congruity360?exp=ubp8&tab=Overview,2,2,0,1.0
Primary Market Data,https://azuremarketplace.microsoft.com/en-us/marketplace/apps/bondintelligenceinc1579558187172.azm-od-mun-dt?exp=ubp8&tab=Overview,1,1,0,1.0
Toolio,https://azuremarketplace.microsoft.com/en-us/marketplace/apps/toolio.toolio?exp=ubp8&tab=Overview,4,4,0,1.0
Ubikite DaaS Manager,https://azuremarketplace.microsoft.com/en-us/marketplace/apps/ubikitellc.ubikite_daas?exp=ubp8&tab=Overview,3,3,0,1.0
CFOUR - Financial Consolidation Tool,https://azuremarketplace.microsoft.com/en-us/marketplace/apps/eunoialimited.cfour_eunoia_mt?exp=ubp8&tab=Overview,1,1,0,1.0
NCache Enterprise Linux,https://azuremarketplace.microsoft.com/en-us/marketplace/apps/alachisoft.ncache_enterprise_50sp2_linux?exp=ubp8&tab=Overview,10,10,0,1.0
Mapwize,https://azuremarketplace.microsoft.com/en-us/marketplace/apps/mapwize.mapwize?exp=ubp8&tab=Overview,6,6,0,1.0
Striim BYOL,https://azuremarketplace.microsoft.com/en-us/marketplace/apps/striim.striimbyol?exp=ubp8&tab=Overview,1,1,0,1.0
Zurvey.io,https://azuremarketplace.microsoft.com/en-us/marketplace/apps/neticle.zurveyio?exp=ubp8&tab=Overview,2,2,0,1.0
Neticle Media Intelligence,https://azuremarketplace.microsoft.com/en-us/marketplace/apps/neticle.neticlemediaintelligence?exp=ubp8&tab=Overview,1,1,0,1.0
Vital CRM - Customer Relationship Management,https://azuremarketplace.microsoft.com/en-us/marketplace/apps/galaxysoftwareservices.vitalcrm?exp=ubp8&tab=Overview,1,1,0,1.0
Brain (Power BI Portal),https://azuremarketplace.microsoft.com/en-us/marketplace/apps/axi4cns1581300458087.biportal_id?exp=ubp8&tab=Overview,1,1,0,1.0
Hammerhead PPM Data Warehouse,https://azuremarketplace.microsoft.com/en-us/marketplace/apps/projility.hammerhead?exp=ubp8&tab=Overview,1,1,0,1.0
NielsenIQ Connect,https://azuremarketplace.microsoft.com/en-us/marketplace/apps/nielsen.nielsen_connect?exp=ubp8&tab=Overview,14,14,0,1.0
JFrog Artifactory on Ubuntu 18.04,https://azuremarketplace.microsoft.com/en-us/marketplace/apps/apps-4-rent.jfrog-artifactory-on-ubuntu-1804?exp=ubp8&tab=Overview,4,4,0,1.0
Kooboo on Windows 2019,https://azuremarketplace.microsoft.com/en-us/marketplace/apps/apps-4-rent.kooboo-on-windows-2019?exp=ubp8&tab=Overview,2,2,0,1.0
Kooboo on Ubuntu 18.04,https://azuremarketplace.microsoft.com/en-us/marketplace/apps/apps-4-rent.kooboo-on-ubuntu-804?exp=ubp8&tab=Overview,2,2,0,1.0
AbanteCart on Ubuntu 18.04,https://azuremarketplace.microsoft.com/en-us/marketplace/apps/apps-4-rent.abantecart-on-ubuntu-1804?exp=ubp8&tab=Overview,1,1,0,1.0
Nagios on Ubuntu 18.04,https://azuremarketplace.microsoft.com/en-us/marketplace/apps/apps-4-rent.nagios-on-ubuntu-1804?exp=ubp8&tab=Overview,4,4,0,1.0
Redis on Ubuntu 18.04,https://azuremarketplace.microsoft.com/en-us/marketplace/apps/apps-4-rent.redis-on-ubuntu-1804?exp=ubp8&tab=Overview,3,3,0,1.0
SLASCONE - Licensing as a Service,https://azuremarketplace.microsoft.com/en-us/marketplace/apps/slascone-gmbh.slascone-saas?exp=ubp8&tab=Overview,2,2,0,1.0
DokuWiki on Ubuntu 18.04,https://azuremarketplace.microsoft.com/en-us/marketplace/apps/apps-4-rent.docuwiki-on-ubuntu-1804?exp=ubp8&tab=Overview,3,3,0,1.0
DokuWiki on Windows 2016 ,https://azuremarketplace.microsoft.com/en-us/marketplace/apps/apps-4-rent.dokuwiki-on-windows-2016?exp=ubp8&tab=Overview,1,1,0,1.0
"Exasol Analytics Database (EnterpriseSupport,PAYG)",https://azuremarketplace.microsoft.com/en-us/marketplace/apps/exasol.exasol-analytics-database-payg?exp=ubp8&tab=Overview,16,16,0,1.0
Elite,https://azuremarketplace.microsoft.com/en-us/marketplace/apps/imagetrendinc.elite?exp=ubp8&tab=Overview,1,1,0,1.0
Apache Solr on Debian,https://azuremarketplace.microsoft.com/en-us/marketplace/apps/apps-4-rent.apache-solr-on-debian?exp=ubp8&tab=Overview,6,6,0,1.0
Quickproject on Windows Server 2019,https://azuremarketplace.microsoft.com/en-us/marketplace/apps/apps-4-rent.quickproject-on-windows-server-2019?exp=ubp8&tab=Overview,5,5,0,1.0
Apache Maven on Ubuntu,https://azuremarketplace.microsoft.com/en-us/marketplace/apps/apps-4-rent.apache-maven-on-ubuntu?exp=ubp8&tab=Overview,3,3,0,1.0
Big Data y Analítica para el Sector Financiero,https://azuremarketplace.microsoft.com/en-us/marketplace/apps/gsgesti0nysistemassac-2632522.quipus_analytics?exp=ubp8&tab=Overview,1,1,0,1.0
MariaDB on Ubuntu 18.04,https://azuremarketplace.microsoft.com/en-us/marketplace/apps/apps-4-rent.mariadb-on-ubuntu-1804?exp=ubp8&tab=Overview,2,2,0,1.0
Cinchy Local Instance,https://azuremarketplace.microsoft.com/en-us/marketplace/apps/cinchy.cinchy-local?exp=ubp8&tab=Overview,20,20,0,1.0
Proxitrak,https://azuremarketplace.microsoft.com/en-us/marketplace/apps/proxigroup.002?exp=ubp8&tab=Overview,2,2,0,1.0
Windows Server 2016 with ClamAV,https://azuremarketplace.microsoft.com/en-us/marketplace/apps/apps-4-rent.clamav-on-windows-server-2016?exp=ubp8&tab=Overview,2,2,0,1.0
Infortel Select,https://azuremarketplace.microsoft.com/en-us/marketplace/apps/isitelemanagementsolutionsllc.isi_infortel?exp=ubp8&tab=Overview,1,1,0,1.0
Dolibarr on Windows Server 2019,https://azuremarketplace.microsoft.com/en-us/marketplace/apps/apps-4-rent.dolibarr-on-windows-server-2019?exp=ubp8&tab=Overview,3,3,0,1.0
Dolibarr on Windows Server 2016,https://azuremarketplace.microsoft.com/en-us/marketplace/apps/apps-4-rent.dolibarr-on-windows-server-2016?exp=ubp8&tab=Overview,2,2,0,1.0
Odoo on Windows Server 2019,https://azuremarketplace.microsoft.com/en-us/marketplace/apps/apps-4-rent.odoo-windows-server-2019?exp=ubp8&tab=Overview,2,2,0,1.0
PostgreSQL on Windows Server 2016,https://azuremarketplace.microsoft.com/en-us/marketplace/apps/apps-4-rent.postgresql-windows-server-2016?exp=ubp8&tab=Overview,3,3,0,1.0
Cloverleaf Integration,https://azuremarketplace.microsoft.com/en-us/marketplace/apps/inforglobalsolutionsinc1022033-1022033.cloverleaf_integration?exp=ubp8&tab=Overview,2,2,0,1.0
Crowdspector | Big data monetization,https://azuremarketplace.microsoft.com/en-us/marketplace/apps/instarea.crowdspector?exp=ubp8&tab=Overview,1,1,0,1.0
Mean.Js On Ubuntu,https://azuremarketplace.microsoft.com/en-us/marketplace/apps/apps-4-rent.mean_js_ubuntu?exp=ubp8&tab=Overview,3,3,0,1.0
Magalix,https://azuremarketplace.microsoft.com/en-us/marketplace/apps/magalix-agent.magalix_agent?exp=ubp8&tab=Overview,1,1,0,1.0
Data Logistics Cloud™ (DLC™),https://azuremarketplace.microsoft.com/en-us/marketplace/apps/skylab.dlc?exp=ubp8&tab=Overview,1,1,0,1.0
Alfabet for Government,https://azuremarketplace.microsoft.com/en-us/marketplace/apps/softwareaggovernmentsolutions.alfabet?exp=ubp8&tab=Overview,1,1,0,1.0
AngularJS on Ubuntu 18.04LTS,https://azuremarketplace.microsoft.com/en-us/marketplace/apps/apps-4-rent.angularjs?exp=ubp8&tab=Overview,2,2,0,1.0
Hubstream Intelligence,https://azuremarketplace.microsoft.com/en-us/marketplace/apps/hubstreaminc.hubintsaas-001?exp=ubp8&tab=Overview,1,1,0,1.0
Salesbook,https://azuremarketplace.microsoft.com/en-us/marketplace/apps/salesbook.salesbook_app?exp=ubp8&tab=Overview,5,5,0,1.0
Automation Anywhere Enterprise,https://azuremarketplace.microsoft.com/en-us/marketplace/apps/automationanywhere.automationexpress?exp=ubp8&tab=Overview,1000,1000,0,1.0
PixAlert Screen monitor,https://azuremarketplace.microsoft.com/en-us/marketplace/apps/bioobservationsystemsltd.sm_2919?exp=ubp8&tab=Overview,1,1,0,1.0
DataCurrent,https://azuremarketplace.microsoft.com/en-us/marketplace/apps/civicainfrastructureinc.datacurrent?exp=ubp8&tab=Overview,12,12,0,1.0
ZAP Data Hub For Azure,https://azuremarketplace.microsoft.com/en-us/marketplace/apps/zap-bi.zap-am-datahub-byodw?exp=ubp8&tab=Overview,33,33,0,1.0
Tibero 6 Enterprise Edition,https://azuremarketplace.microsoft.com/en-us/marketplace/apps/tmaxsoft.tmax-tibero6ee?exp=ubp8&tab=Overview,3,3,0,1.0
"IIS 10 on Windows Server for Python, MySQL and PHP",https://azuremarketplace.microsoft.com/en-us/marketplace/apps/apps-4-rent.dev-tool-windows-2016?exp=ubp8&tab=Overview,20,20,0,1.0
PriceSynergy advanced eCommerce market analytics,https://azuremarketplace.microsoft.com/en-us/marketplace/apps/tailsoftwareltdtradingaspricesynergy.pricesynergy-ecommerce-analytics?exp=ubp8&tab=Overview,1,1,0,1.0
GMP Audit - Good Manufacturing Practice Audit,https://azuremarketplace.microsoft.com/en-us/marketplace/apps/softools.gmpaudit?exp=ubp8&tab=Overview,1,1,0,1.0
FirstHive,https://azuremarketplace.microsoft.com/en-us/marketplace/apps/firsthivetechcorp1593607196786.firsthive_saas?exp=ubp8&tab=Overview,12,12,0,1.0
FirstHive,https://azuremarketplace.microsoft.com/en-us/marketplace/apps/firsthivetechcorp1593607196786.firsthive_saas?exp=ubp8&tab=Overview,12,12,0,1.0
Sympa,https://azuremarketplace.microsoft.com/en-us/marketplace/apps/sympahr.sympahr?exp=ubp8&tab=Overview,1,1,0,1.0
NetSuite Reporting (Suiteapp: ZoneReporting),https://azuremarketplace.microsoft.com/en-us/marketplace/apps/satoritechnologyllc.satori_reporting?exp=ubp8&tab=Overview,1,1,0,1.0
LibreOffice on Windows Server 2019,https://azuremarketplace.microsoft.com/en-us/marketplace/apps/apps-4-rent.libreoffice-on-windows-server-2019?exp=ubp8&tab=Overview,3,3,0,1.0
Autosphere - Telecom RPA Platform,https://azuremarketplace.microsoft.com/en-us/marketplace/apps/mercurialminds.autosphere?exp=ubp8&tab=Overview,1,1,0,1.0
Data Versioning & Lineage for AML with Pachyderm,https://azuremarketplace.microsoft.com/en-us/marketplace/apps/pachyderminc1585170006545.pachyderm_aml_enablement?exp=ubp8&tab=Overview,13,13,0,1.0
Axonize Energy Management and Orchestration,https://azuremarketplace.microsoft.com/en-us/marketplace/apps/axonize.axonize-energy-management?exp=ubp8&tab=Overview,3,3,0,1.0
Axon,https://azuremarketplace.microsoft.com/en-us/marketplace/apps/axon.axon_evidence?exp=ubp8&tab=Overview,3,3,0,1.0
Power BI voor Exact Online,https://azuremarketplace.microsoft.com/en-us/marketplace/apps/beye.powerbi-dashboard-voor-exactonline?exp=ubp8&tab=Overview,1,1,0,1.0
Customer Data Connector for Adobe and Azure,https://azuremarketplace.microsoft.com/en-us/marketplace/apps/bitbang.sol-33410-wtt?exp=ubp8&tab=Overview,1,1,0,1.0
Explorium External Data Platform,https://azuremarketplace.microsoft.com/en-us/marketplace/apps/explorium1622538050542.explorium_external_data_platform_01?exp=ubp8&tab=Overview,13,13,0,1.0
Passport 360 – Compliance Process Automation,https://azuremarketplace.microsoft.com/en-us/marketplace/apps/passport360.p360_transact_user?exp=ubp8&tab=Overview,1,1,0,1.0
ThinkAutomation,https://azuremarketplace.microsoft.com/en-us/marketplace/apps/parkersoftwarelimited1609786657569.thinkautomation?exp=ubp8&tab=Overview,1,1,0,1.0
Usee Data Centric Demand Forecast,https://azuremarketplace.microsoft.com/en-us/marketplace/apps/fpt-softwarecoltd1603174390415.fsoft_usee?exp=ubp8&tab=Overview,2,2,0,1.0
Targo Integration Platform,https://azuremarketplace.microsoft.com/en-us/marketplace/apps/exghtssrl.targo_azure?exp=ubp8&tab=Overview,1,1,0,1.0
Lenses.io,https://azuremarketplace.microsoft.com/en-us/marketplace/apps/lensesioltd.lenses-io?exp=ubp8&tab=Overview,10,10,0,1.0
Brackets On Windows Server 2019,https://azuremarketplace.microsoft.com/en-us/marketplace/apps/apps-4-rent.brackets-windows-server-2019?exp=ubp8&tab=Overview,3,3,0,1.0
Geoserver On Windows Server 2019,https://azuremarketplace.microsoft.com/en-us/marketplace/apps/apps-4-rent.geoserver-on-windows-server-2019?exp=ubp8&tab=Overview,5,5,0,1.0
Blender 3D On Windows Server 2016,https://azuremarketplace.microsoft.com/en-us/marketplace/apps/apps-4-rent.blender-3d-windows-server-2016?exp=ubp8&tab=Overview,17,17,0,1.0
Jenkins On Ubuntu Bionic Beaver,https://azuremarketplace.microsoft.com/en-us/marketplace/apps/apps-4-rent.jenkins-on-ubuntu-bionic-beaver?exp=ubp8&tab=Overview,21,21,0,1.0
Bluefish Editor on Windows Server 2019,https://azuremarketplace.microsoft.com/en-us/marketplace/apps/apps-4-rent.bluefish-editor-windows-server-2019?exp=ubp8&tab=Overview,3,3,0,1.0
Brackets,https://azuremarketplace.microsoft.com/en-us/marketplace/apps/apps-4-rent.brackets-windows-server-2016?exp=ubp8&tab=Overview,4,4,0,1.0
Xampp Windows Server 2019,https://azuremarketplace.microsoft.com/en-us/marketplace/apps/apps-4-rent.xampp-windows-server-2019?exp=ubp8&tab=Overview,10,10,0,1.0
Cloud Desktop,https://azuremarketplace.microsoft.com/en-us/marketplace/apps/apps-4-rent.cloud-desktop?exp=ubp8&tab=Overview,10,10,0,1.0
Xampp,https://azuremarketplace.microsoft.com/en-us/marketplace/apps/apps-4-rent.xampp-windows-server-2016?exp=ubp8&tab=Overview,6,6,0,1.0
GnuCash on Windows Server 2016,https://azuremarketplace.microsoft.com/en-us/marketplace/apps/apps-4-rent.guncash-windows-server-2016?exp=ubp8&tab=Overview,3,3,0,1.0
GnuCash on Windows Server 2019,https://azuremarketplace.microsoft.com/en-us/marketplace/apps/apps-4-rent.guncash-windows-server-2019?exp=ubp8&tab=Overview,2,2,0,1.0
IIS on Windows Server 2016,https://azuremarketplace.microsoft.com/en-us/marketplace/apps/apps-4-rent.iis-on-windows-server-2016?exp=ubp8&tab=Overview,25,25,0,1.0
Teradata Unity (IntelliSphere),https://azuremarketplace.microsoft.com/en-us/marketplace/apps/teradata.teradata-unity-intellisphere-template?exp=ubp8&tab=Overview,3,3,0,1.0
Striim,https://azuremarketplace.microsoft.com/en-us/marketplace/apps/striim.striimfullplatform?exp=ubp8&tab=Overview,1,1,0,1.0
HubStor Test Drive,https://azuremarketplace.microsoft.com/en-us/marketplace/apps/hubstor-inc.hubstor-demo?exp=ubp8&tab=Overview,5,5,0,1.0
Cautela Labs Log Management and SOC,https://azuremarketplace.microsoft.com/en-us/marketplace/apps/cautelalabs.log_management?exp=ubp8&tab=Overview,2,2,0,1.0
Data Management Accelerator Suite,https://azuremarketplace.microsoft.com/en-us/marketplace/apps/blueprint-consulting-services-llc.conduit?exp=ubp8&tab=Overview,1,1,0,1.0
ClickCompliance,https://azuremarketplace.microsoft.com/en-us/marketplace/apps/clickcompliance.clickcompliance-azure?exp=ubp8&tab=Overview,3,3,0,1.0
Jenkins-Docker CE on Ubuntu Bionic Beaver,https://azuremarketplace.microsoft.com/en-us/marketplace/apps/apps-4-rent.jenkins-dockerce-on-ubuntu-bionic-beaver?exp=ubp8&tab=Overview,24,24,0,1.0
quasardb,https://azuremarketplace.microsoft.com/en-us/marketplace/apps/quasardb.quasardb?exp=ubp8&tab=Overview,3,3,0,1.0
ScaleArc for MySQL,https://azuremarketplace.microsoft.com/en-us/marketplace/apps/scalearc.scalearc_mysql-server?exp=ubp8&tab=Overview,1,1,0,1.0
VisualRM,https://azuremarketplace.microsoft.com/en-us/marketplace/apps/visualsoft-center.visualrm?exp=ubp8&tab=Overview,2,2,0,1.0
MarkLogic Multi-Model Database: Developer v.9,https://azuremarketplace.microsoft.com/en-us/marketplace/apps/marklogic.marklogic-developer-9?exp=ubp8&tab=Overview,1,1,0,1.0
Teradata Data Mover (IntelliSphere),https://azuremarketplace.microsoft.com/en-us/marketplace/apps/teradata.teradata-data-mover-intellisphere-template?exp=ubp8&tab=Overview,3,3,0,1.0
ScaleArc for SQL Server,https://azuremarketplace.microsoft.com/en-us/marketplace/apps/scalearc.scalearc_sql_server?exp=ubp8&tab=Overview,1,1,0,1.0
NCBI BLAST+ 2.2.31,https://azuremarketplace.microsoft.com/en-us/marketplace/apps/ncbi.ncbi-free-2-2-31?exp=ubp8&tab=Overview,1,1,0,1.0
Teradata Data Mover,https://azuremarketplace.microsoft.com/en-us/marketplace/apps/teradata.teradata-data-mover-template?exp=ubp8&tab=Overview,3,3,0,1.0
AISE TensorFlow GPU Production,https://azuremarketplace.microsoft.com/en-us/marketplace/apps/jetware-srl.tensorflow_cuda_production?exp=ubp8&tab=Overview,1,1,0,1.0
Cloudbreak for Hortonworks Data Platform ,https://azuremarketplace.microsoft.com/en-us/marketplace/apps/hortonworks.cloudbreak-for-hortonworks-data-platform-st?exp=ubp8&tab=Overview,2,2,0,1.0
Denodo Enterprise Plus (Annual),https://azuremarketplace.microsoft.com/en-us/marketplace/apps/denodo.denodo-8_0-ent_plus-saas-annual?exp=ubp8&tab=Overview,34,35,1,1.0
Striim for Real-Time Integration to SQL Database,https://azuremarketplace.microsoft.com/en-us/marketplace/apps/striim.sqldbintegration?exp=ubp8&tab=Overview,1,1,0,1.0
quasardb cluster,https://azuremarketplace.microsoft.com/en-us/marketplace/apps/quasardb.quasardb-xtp-cluster?exp=ubp8&tab=Overview,3,3,0,1.0
Panorama Necto 16.1 - Business Intelligence,https://azuremarketplace.microsoft.com/en-us/marketplace/apps/panorama-necto.panorama-necto-16-business-intelligence?exp=ubp8&tab=Overview,18,18,0,1.0
Zoho Sprints,https://azuremarketplace.microsoft.com/en-us/marketplace/apps/zohocorp.zohosprints?exp=ubp8&tab=Overview,151,158,7,1.0
Couchbase Sync Gateway Enterprise,https://azuremarketplace.microsoft.com/en-us/marketplace/apps/couchbase.couchbase-sync-gateway-enterprise?exp=ubp8&tab=Overview,6,6,0,1.0
Couchbase Server Enterprise,https://azuremarketplace.microsoft.com/en-us/marketplace/apps/couchbase.couchbase-server-enterprise?exp=ubp8&tab=Overview,86,90,4,1.0
Flexera IT Asset Management,https://azuremarketplace.microsoft.com/en-us/marketplace/apps/flexerasoftware.flexera_flexnet_manager?exp=ubp8&tab=Overview,39,39,0,1.0
Dace IT℠Intelligent Traffic Management 2022,https://azuremarketplace.microsoft.com/en-us/marketplace/apps/daceitdbasensetrafficpulse1579892024934.sense-traffic-pulse-itm-2021?exp=ubp8&tab=Overview,1,1,0,1.0
OpenVINO™ Smart-City Reference Implementation VM,https://azuremarketplace.microsoft.com/en-us/marketplace/apps/daceitdbasensetrafficpulse1579892024934.2021-04-16-11?exp=ubp8&tab=Overview,1,1,0,1.0
Theum,https://azuremarketplace.microsoft.com/en-us/marketplace/apps/theumag1596442827072.theumaio?exp=ubp8&tab=Overview,1,1,0,1.0
CENTERSIGHT scale - Your flexible IoT solution,https://azuremarketplace.microsoft.com/en-us/marketplace/apps/deviceinsightgmbh-4961725.centersight-scale?exp=ubp8&tab=Overview,1,1,0,1.0
"rgOne™, Intelligent Orchestration",https://azuremarketplace.microsoft.com/en-us/marketplace/apps/redpoint-global.redpoint-interaction?exp=ubp8&tab=Overview,1,1,0,1.0
Enterprise - AI Data management platform,https://azuremarketplace.microsoft.com/en-us/marketplace/apps/aimmocoltd1612334092473.aimmo_enterprise?exp=ubp8&tab=Overview,1,1,0,1.0
Conversational BoT,https://azuremarketplace.microsoft.com/en-us/marketplace/apps/bitonictechnologylabsprivatelimited-5053986.sol-1873-jyp?exp=ubp8&tab=Overview,1,1,0,1.0
WhoTeach,https://azuremarketplace.microsoft.com/en-us/marketplace/apps/socialthingumsrl1589534581586.whoteach?exp=ubp8&tab=Overview,1,1,0,1.0
Skeyetech,https://azuremarketplace.microsoft.com/en-us/marketplace/apps/azurdrones1615973849724.skeyetech?exp=ubp8&tab=Overview,1,1,0,1.0
SlashNext Complete™ Integrated Cloud Messaging Security,https://azuremarketplace.microsoft.com/en-us/marketplace/apps/slashnext1598548183597.slashnext-phishing-protection?exp=ubp8&tab=Overview,31,31,0,1.0
Pachyderm Enterprise,https://azuremarketplace.microsoft.com/en-us/marketplace/apps/pachyderminc1585170006545.pachyderm_enterprise_3?exp=ubp8&tab=Overview,13,13,0,1.0
Chatbot Smart RH,https://azuremarketplace.microsoft.com/en-us/marketplace/apps/alexsyssolutions1582457246899.smartrh_id?exp=ubp8&tab=Overview,1,1,0,1.0
Data Annotation AI/ML - Images Video Text,https://azuremarketplace.microsoft.com/en-us/marketplace/apps/diffgraminc1614713698245.data-annotation-saas?exp=ubp8&tab=Overview,1,1,0,1.0
Senso Cloud,https://azuremarketplace.microsoft.com/en-us/marketplace/apps/renatosoftware.senso_cloud_2020?exp=ubp8&tab=Overview,1,1,0,1.0
Game Data Science for Responsible Gambling,https://azuremarketplace.microsoft.com/en-us/marketplace/apps/futureanthemltd1581346827598.gamedatascience_saferplay?exp=ubp8&tab=Overview,1,1,0,1.0
Data Analytics Solution - Boardroom,https://azuremarketplace.microsoft.com/en-us/marketplace/apps/fpt-softwarecoltd1603174390415.fsoft_boardroom?exp=ubp8&tab=Overview,1,1,0,1.0
Verloop.io,https://azuremarketplace.microsoft.com/en-us/marketplace/apps/magiclaneappservicesprivatelimited1606838760867.verloop_ind_1?exp=ubp8&tab=Overview,224,227,3,1.0
Verloop.io,https://azuremarketplace.microsoft.com/en-us/marketplace/apps/magiclaneappservicesprivatelimited1606838760867.verloop_ind_1?exp=ubp8&tab=Overview,224,227,3,1.0
Skalable Stream - AI driven Invoice Automation,https://azuremarketplace.microsoft.com/en-us/marketplace/apps/defaultpublisherskalable.skalable_stream?exp=ubp8&tab=Overview,2,2,0,1.0
AuraQuantic Starter Plan,https://azuremarketplace.microsoft.com/en-us/marketplace/apps/auraportal.auraquantic-starter-plan?exp=ubp8&tab=Overview,3,3,0,1.0
Yooz,https://azuremarketplace.microsoft.com/en-us/marketplace/apps/yooz1581494864797.yooz?exp=ubp8&tab=Overview,1,1,0,1.0
Photon Commerce PDF Extraction AI,https://azuremarketplace.microsoft.com/en-us/marketplace/apps/photoncommerce1584479187866.photon?exp=ubp8&tab=Overview,6,6,0,1.0
"MOHR, Cloud based HR system",https://azuremarketplace.microsoft.com/en-us/marketplace/apps/rightfoot1592392062672.mohr?exp=ubp8&tab=Overview,1,1,0,1.0
Symend,https://azuremarketplace.microsoft.com/en-us/marketplace/apps/symendinc.symend_initialoffer_1?exp=ubp8&tab=Overview,1,1,0,1.0
Symend,https://azuremarketplace.microsoft.com/en-us/marketplace/apps/symendinc.symend_initialoffer_1?exp=ubp8&tab=Overview,1,1,0,1.0
Trendalyze - SaaS,https://azuremarketplace.microsoft.com/en-us/marketplace/apps/trendalyzecom1595433488183.offer-listing?exp=ubp8&tab=Overview,19,19,0,1.0
DataWeave Commerce Intelligence,https://azuremarketplace.microsoft.com/en-us/marketplace/apps/infoweaveanalyticsprivatelimited1586947967858.dataweave-retail-intelligence?exp=ubp8&tab=Overview,78,78,0,1.0
Vozy,https://azuremarketplace.microsoft.com/en-us/marketplace/apps/vozy1593119673634.lili?exp=ubp8&tab=Overview,20,20,0,1.0
AcuitySpark – Advanced B2B/B2C analytics platform,https://azuremarketplace.microsoft.com/en-us/marketplace/apps/visionetsystems.acuityspark?exp=ubp8&tab=Overview,2,2,0,1.0
Leges.AI,https://azuremarketplace.microsoft.com/en-us/marketplace/apps/adddoo.legesai?exp=ubp8&tab=Overview,2,2,0,1.0
Hexplora Healthcare Analytics,https://azuremarketplace.microsoft.com/en-us/marketplace/apps/hexplora1591977390734.hexplora_analytics_saas?exp=ubp8&tab=Overview,1,1,0,1.0
Customer 360 Analytics,https://azuremarketplace.microsoft.com/en-us/marketplace/apps/kocsistem.customer360analytics?exp=ubp8&tab=Overview,2,2,0,1.0
X0PA AI Recruiter,https://azuremarketplace.microsoft.com/en-us/marketplace/apps/x0paai.x0pa_ai_recruiter_transact?exp=ubp8&tab=Overview,31,31,0,1.0
Amelia,https://azuremarketplace.microsoft.com/en-us/marketplace/apps/ipsoftincorporated1590591167927.ipsoft_amelia?exp=ubp8&tab=Overview,1,1,0,1.0
X0PA ROOM,https://azuremarketplace.microsoft.com/en-us/marketplace/apps/x0paai.x0pa_room_product?exp=ubp8&tab=Overview,31,31,0,1.0
Arkose Labs Fraud Prevention Platform,https://azuremarketplace.microsoft.com/en-us/marketplace/apps/arkoselabs1589934191756.arkoselabs?exp=ubp8&tab=Overview,40,41,1,1.0
Nia Contracts Analysis,https://azuremarketplace.microsoft.com/en-us/marketplace/apps/edgevervesystemsltd.nia_contracts_analysis?exp=ubp8&tab=Overview,4,4,0,1.0
HIVERY Curate,https://azuremarketplace.microsoft.com/en-us/marketplace/apps/hivery1584673929611.hivery-propel?exp=ubp8&tab=Overview,1,1,0,1.0
Personetics' Engagement Platform,https://azuremarketplace.microsoft.com/en-us/marketplace/apps/personeticstechnologiesltd.personetics_engage?exp=ubp8&tab=Overview,1,1,0,1.0
Akridata Data Explorer,https://azuremarketplace.microsoft.com/en-us/marketplace/apps/akridatainc1591769146629.dataexplorer_saas?exp=ubp8&tab=Overview,1,1,0,1.0
Striim Cloud Enterprise,https://azuremarketplace.microsoft.com/en-us/marketplace/apps/striim.striim_cloud_enterprise?exp=ubp8&tab=Overview,1,1,0,1.0
ArcGIS Pro,https://azuremarketplace.microsoft.com/en-us/marketplace/apps/esri.pro-byol?exp=ubp8&tab=Overview,172,180,8,1.0
ArcGIS Pro,https://azuremarketplace.microsoft.com/en-us/marketplace/apps/esri.pro-byol?exp=ubp8&tab=Overview,172,180,8,1.0
Denodo Standard (Annual),https://azuremarketplace.microsoft.com/en-us/marketplace/apps/denodo.denodo-8_0-std-saas-annual?exp=ubp8&tab=Overview,34,35,1,1.0
Golang on Ubuntu20.04LTS,https://azuremarketplace.microsoft.com/en-us/marketplace/apps/apps-4-rent.golang-on-ubuntu20?exp=ubp8&tab=Overview,1,1,0,1.0
Verloop.io,https://azuremarketplace.microsoft.com/en-us/marketplace/apps/magiclaneappservicesprivatelimited1606838760867.verloop_v1?exp=ubp8&tab=Overview,224,227,3,1.0
Verloop.io,https://azuremarketplace.microsoft.com/en-us/marketplace/apps/magiclaneappservicesprivatelimited1606838760867.verloop_v1?exp=ubp8&tab=Overview,224,227,3,1.0
Observe.AI Contact Center AI,https://azuremarketplace.microsoft.com/en-us/marketplace/apps/observerazorsharp.observe_ai?exp=ubp8&tab=Overview,191,196,5,1.0
ThroughPut ELITE - Manufacturing and Supply Chain SaaS,https://azuremarketplace.microsoft.com/en-us/marketplace/apps/throughput.throughput_elite?exp=ubp8&tab=Overview,1,1,0,1.0
Blue Prism Intelligent Automation,https://azuremarketplace.microsoft.com/en-us/marketplace/apps/blueprismlimited-4827145.blueprism?exp=ubp8&tab=Overview,3,3,0,1.0
Outreach Sales Execution Platform,https://azuremarketplace.microsoft.com/en-us/marketplace/apps/outreach.outreach-azure?exp=ubp8&tab=Overview,998,998,0,1.0
Qlik Data Integration Platform (formerly Attunity),https://azuremarketplace.microsoft.com/en-us/marketplace/apps/qlik.qlik_data_integration_platform?exp=ubp8&tab=Overview,125,122,-3,1.0
Qlik Sense,https://azuremarketplace.microsoft.com/en-us/marketplace/apps/qlik.qlik-sense?exp=ubp8&tab=Overview,642,660,18,1.0
Dremio Community Edition,https://azuremarketplace.microsoft.com/en-us/marketplace/apps/dremiocorporation.dremio_ce?exp=ubp8&tab=Overview,43,44,1,1.0
Celonis EMS,https://azuremarketplace.microsoft.com/en-us/marketplace/apps/fncelonis.celonis_ems?exp=ubp8&tab=Overview,1,1,0,1.0
Cisco Catalyst 9800-CL Wireless Controller,https://azuremarketplace.microsoft.com/en-us/marketplace/apps/cisco.cisco-wlc-basic-template?exp=ubp8&tab=Overview,1,1,0,1.0
Tableau Server,https://azuremarketplace.microsoft.com/en-us/marketplace/apps/tableau.tableau-server?exp=ubp8&tab=Overview,1001,1000,-1,1.0
UiPath Orchestrator,https://azuremarketplace.microsoft.com/en-us/marketplace/apps/uipath-5054924.uipath_orchestrator_automated_deployment_webapp?exp=ubp8&tab=Overview,3,3,0,1.0
Prometheus packaged by Data Science Dojo,https://azuremarketplace.microsoft.com/en-us/marketplace/apps/datasciencedojo1586563145740.prometheus1?exp=ubp8&tab=Overview,1,1,0,1.0
Canvass AI,https://azuremarketplace.microsoft.com/en-us/marketplace/apps/canvassanalyticsinc1617115082696.canvass-ai?exp=ubp8&tab=Overview,3,3,0,1.0
IBM Cloud Pak for Data,https://azuremarketplace.microsoft.com/en-us/marketplace/apps/ibm-usa-ny-armonk-hq-6275750-ibmcloud-asperia.cloud-pak-for-data-ibm?exp=ubp8&tab=Overview,86,86,0,1.0
Voicero,https://azuremarketplace.microsoft.com/en-us/marketplace/apps/woopi.voicero?exp=ubp8&tab=Overview,3,3,0,1.0
Data Migrator for Azure,https://azuremarketplace.microsoft.com/en-us/marketplace/apps/wandisco.ldma?exp=ubp8&tab=Overview,2,2,0,1.0
SQL Server 2019 Reporting Services,https://azuremarketplace.microsoft.com/en-us/marketplace/apps/microsoftpowerbi.ssrs-2019?exp=ubp8&tab=Overview,1,1,0,1.0
Talend Cloud Data Integration,https://azuremarketplace.microsoft.com/en-us/marketplace/apps/talend.talendclouddi?exp=ubp8&tab=Overview,109,109,0,1.0
Data Science Virtual Machine - Windows 2019,https://azuremarketplace.microsoft.com/en-us/marketplace/apps/microsoft-dsvm.dsvm-win-2019?exp=ubp8&tab=Overview,1,1,0,1.0
Ascend Data Automation Cloud,https://azuremarketplace.microsoft.com/en-us/marketplace/apps/ascend.ascend-io-azure?exp=ubp8&tab=Overview,1,1,0,1.0
Neo4j Enterprise Edition,https://azuremarketplace.microsoft.com/en-us/marketplace/apps/neo4j.neo4j-ee?exp=ubp8&tab=Overview,122,128,6,1.0
Power BI Viewer,https://azuremarketplace.microsoft.com/en-us/marketplace/apps/bismart.powerbi_viewer_azure_app?exp=ubp8&tab=Overview,1,1,0,1.0
Azure Stream Analytics on IoT Edge,https://azuremarketplace.microsoft.com/en-us/marketplace/apps/microsoft.stream-analytics-on-iot-?exp=ubp8&tab=Overview,13,13,0,1.0
Azure Video Analyzer Edge,https://azuremarketplace.microsoft.com/en-us/marketplace/apps/azure-appliedai-services.azure-video-analyzer?exp=ubp8&tab=Overview,1,1,0,1.0
Scriptix speech to text for automatic transcription and subtitling,https://azuremarketplace.microsoft.com/en-us/marketplace/apps/zoommedia.speech-to-text?exp=ubp8&tab=Overview,2,2,0,1.0
NVIDIA GPU-Optimized VMI,https://azuremarketplace.microsoft.com/en-us/marketplace/apps/nvidia.ngc_azure_17_11?exp=ubp8&tab=Overview,1,1,0,1.0
Content Moderator,https://azuremarketplace.microsoft.com/en-us/marketplace/apps/Microsoft.CognitiveServicesContentModerator?exp=ubp8&tab=Overview,23,22,-1,1.0
ArcGIS Pro,https://azuremarketplace.microsoft.com/en-us/marketplace/apps/esri.arcgis-pro-saas?exp=ubp8&tab=Overview,172,180,8,1.0
ArcGIS Pro,https://azuremarketplace.microsoft.com/en-us/marketplace/apps/esri.arcgis-pro-saas?exp=ubp8&tab=Overview,172,180,8,1.0
QnA Maker,https://azuremarketplace.microsoft.com/en-us/marketplace/apps/Microsoft.CognitiveServicesQnAMaker?exp=ubp8&tab=Overview,184,187,3,1.0
Face,https://azuremarketplace.microsoft.com/en-us/marketplace/apps/Microsoft.CognitiveServicesFace?exp=ubp8&tab=Overview,204,205,1,1.0
Computer Vision,https://azuremarketplace.microsoft.com/en-us/marketplace/apps/Microsoft.CognitiveServicesComputerVision?exp=ubp8&tab=Overview,310,320,10,1.0
Time Series Insights,https://azuremarketplace.microsoft.com/en-us/marketplace/apps/Microsoft.TimeSeriesInsightsEnvironment?exp=ubp8&tab=Overview,87,87,0,1.0
Data Catalog,https://azuremarketplace.microsoft.com/en-us/marketplace/apps/Microsoft.DataCatalogGalleryPackage?exp=ubp8&tab=Overview,46,46,0,1.0
IT Service Management Connector,https://azuremarketplace.microsoft.com/en-us/marketplace/apps/Microsoft.ITSMConnector?exp=ubp8&tab=Overview,6,6,0,1.0
Custom Vision,https://azuremarketplace.microsoft.com/en-us/marketplace/apps/Microsoft.CognitiveServicesCustomVision?exp=ubp8&tab=Overview,45,47,2,1.0
UiPath Enterprise RPA Platform,https://azuremarketplace.microsoft.com/en-us/marketplace/apps/uipath-5054924.uipath_automation_platform?exp=ubp8&tab=Overview,1000,1000,0,1.0
Medius AP Automation for Dynamics,https://azuremarketplace.microsoft.com/en-us/marketplace/apps/mediussoftwareinc.mediusincbusinessspendmanagementsuite?exp=ubp8&tab=Overview,1,1,0,1.0
Smart Inventory Planning and Optimization,https://azuremarketplace.microsoft.com/en-us/marketplace/apps/smartsoftwareinc1588106237289.smart-ipo-2021v6?exp=ubp8&tab=Overview,4,3,-1,0.8
ClickCompliance,https://azuremarketplace.microsoft.com/en-us/marketplace/apps/clickcompliance.clickcompliance-azure?exp=ubp8&tab=Overview,7,3,-4,0.4
Blue Prism Intelligent Automation,https://azuremarketplace.microsoft.com/en-us/marketplace/apps/blueprismlimited-4827145.blueprismweb?exp=ubp8&tab=Overview,3,1,-2,0.3
Metrikus ProductiveSpace,https://azuremarketplace.microsoft.com/en-us/marketplace/apps/metrikuslimited1622033297710.workplace?exp=ubp8&tab=Overview,3,1,-2,0.3
Adobe Journey Optimizer,https://azuremarketplace.microsoft.com/en-us/marketplace/apps/adobe.adobe_journey_optimizer_saas?exp=ubp8&tab=Overview,21,,,
Grafana,https://azuremarketplace.microsoft.com/en-us/marketplace/apps/bactonet1668782193190.grafana-stackhero?exp=ubp8&tab=Overview,107,,,
Verint Workforce Optimization,https://azuremarketplace.microsoft.com/en-us/marketplace/apps/groupelitecommunicationsinc1620843022650.verint_workforce_optimization_production?exp=ubp8&tab=Overview,1,,,
Parloa,https://azuremarketplace.microsoft.com/en-us/marketplace/apps/parloagmbh1622447695393.parloa3?exp=ubp8&tab=Overview,1,,,
Clootrack,https://azuremarketplace.microsoft.com/en-us/marketplace/apps/clootracksoftwarelabsprivatelimited1687326738554.clootrack?exp=ubp8&tab=Overview,31,,,
Feedyou Platform,https://azuremarketplace.microsoft.com/en-us/marketplace/apps/feedyou-ai.feedyou-platform?exp=ubp8&tab=Overview,2,,,
Zscaler Digital Experience,https://azuremarketplace.microsoft.com/en-us/marketplace/apps/zscaler1579058425289.zdx_flat_rate?exp=ubp8&tab=Overview,18,,,
PowerAssist™ - Tableau to Power BI Migration ROI Calculator,https://azuremarketplace.microsoft.com/en-us/marketplace/apps/nousinfosystemsinc.powerassist-tableau-to-powerbi-migration?exp=ubp8&tab=Overview,1,,,
ZoomCharts Drill Down PRO Visuals for Power BI,https://azuremarketplace.microsoft.com/en-us/marketplace/apps/32204330.saas-raq?exp=ubp8&tab=Overview,41,,,
Usee Data Centric Demand Forecast,https://azuremarketplace.microsoft.com/en-us/marketplace/apps/intellinetcorporation1605813700624.usee_data_centric_demand_forecast?exp=ubp8&tab=Overview,2,,,
Cisco Catalyst 9800-CL Wireless Controller,https://azuremarketplace.microsoft.com/en-us/marketplace/apps/cisco.cisco-wlc-template?exp=ubp8&tab=Overview,1,,,
Incident Management System,https://azuremarketplace.microsoft.com/en-us/marketplace/apps/cognitensortechnologypvtltd1601967730980.incident-mgmt?exp=ubp8&tab=Overview,2,,,
Zetaris - Build your Data Mesh (VM),https://azuremarketplace.microsoft.com/en-us/marketplace/apps/zetarisptyltd1653890360235.zetaris_vm?exp=ubp8&tab=Overview,3,,,
C3 AI Application Platform,https://azuremarketplace.microsoft.com/en-us/marketplace/apps/c3iotinc.c3_ai_suite_transact?exp=ubp8&tab=Overview,1,,,
Cloudera Data Platform (CDP),https://azuremarketplace.microsoft.com/en-us/marketplace/apps/cloudera.cloudera-data-platform-public-cloud?exp=ubp8&tab=Overview,27,,,
Fivetran Data Pipelines,https://azuremarketplace.microsoft.com/en-us/marketplace/apps/fivetran.fivetran_data_pipelines_2023?exp=ubp8&tab=Overview,349,,,
Snowflake,https://azuremarketplace.microsoft.com/en-us/marketplace/apps/carahsofttechnologycorporation1595268429697.snowflake?exp=ubp8&tab=Overview,442,,,